Tweet	Cleaned_Text	Sentiment
- disaat semua cowok berusaha melacak perhatian gue. loe lantas remehkan perhatian yg gue kasih khusus ke elo. basic elo cowok bego ! ! !'	['cowok usaha lacak perhati gue lantas remeh perhati gue kasih khusus basic cowok bego']	negative
RT USER: USER siapa yang telat ngasih tau elu?edan sarap gue bergaul dengan cigax jifla calis sama siapa noh licew juga'	['telat tau edan sarap gue gaul cigax jifla cal licew']	negative
USER USER AKU ITU AKU\n\nKU TAU MATAMU SIPIT TAPI DILIAT DARI MANA ITU AKU'	['ku tau mata sipit']	positive
USER USER Kaum cebong kapir udah keliatan dongoknya dari awal tambah dongok lagi hahahah'	['kaum cebong kafir dongok dungu haha']	negative
USER Ya bani taplak dkk \xf0\x9f\x98\x84\xf0\x9f\x98\x84\xf0\x9f\x98\x84'	['ya bani taplak kawan kawan xf0 x9f x98 x84 xf0 x9f x98 x84 xf0 x9f x98 x84']	negative
deklarasi pilkada 2018 aman dan anti hoax warga dukuh sari jabon	['deklarasi pilih kepala daerah 2018 aman anti hoaks warga dukuh sari jabon']	neutral
Gue baru aja kelar re-watch Aldnoah Zero!!! paling kampret emang endingnya! 2 karakter utama cowonya kena friendzone bray! XD URL	['gue selesai re watch aldnoah zero kampret 2 karakter utama cowok kena friendzone bro xd uniform resource locator']	negative
Nah admin belanja satu lagi port terbaik nak makan Ais Kepal Milo, Ais Kepal Horlicks atau Cendol Toping kaw kaw. ð??­; ; Doket mano tu ? Gerai Rojak Mertuaku - Taipan 2 (depan TWINS BABY &amp; ROMANTIKA / Bank Islam Senawang) ð???,0,0,0,0,0,0,0,0,0,0,0,0;;;;;;;;;;;;	['admin belanja po baik nak makan ais kepal milo ais kepal horlicks cendol toping kau kau doket gerai rozak me uaku taipan 2 kembar baby amp romantika bank islam senawang 0 0 0 0 0 0 0 0 0 0 0 0']	negative
USER Enak lg klo smbil ngewe'	['enak ngewe']	positive
USER USER USER USER BANCI KALENG MALU GA BISA JAWAB PERTANYAAN KAMI DARI 2 HARI LALU.... NYUNGSEP KOE USER URL	['banci kaleng malu pe anyaan 2 nyungsep koe uniform resource locator']	negative
Kalo belajar ekonomi mestinya jago memprivatisasi hati orang. Duh.. ironi USER	['ajar ekonomi mesti jago privatisasi hati orang aduh ironi']	negative
Aktor huruhara 98 Prabowo S ingin lengserkan pemerintahan Jokowi.... Nyata	['aktor huru hara 98 prabowo si lengser perintah jokowi nyata']	negative
USER Bu guru enakan jadi jablay atau guru esde sih.\nKayaknya menikmati jadi pecun ini guru.'	['bu guru enak jablay guru sekolah dasar sih kayak nikmat pecun guru']	negative
Belakangan ini kok fikiran ampas banget ya'	['pikir ampas banget ya']	negative
Ari sarua beki mah repeh monyet\xf0\x9f\x98\x86\xf0\x9f\x98\x86'	['ari bek rapi monyet xf0 x9f x98 x86 xf0 x9f x98 x86']	positive
Jadi cowo itu harus Gantle kalo ga Gantle itu namanya BANCI !'	['cowok gantle gantle nama banci']	negative
USER Slga mnr bom \xf0\x9f\x98\x82'	['alga mnr bom xf0 x9f x98 x82']	negative
USER kalo kamu noob pasti peluang disakitin nya lebih gede si'	['noob peluang sakit nya gede sih']	negative
PELAJAR SMA KEC BILAH HILIR DEKLARASI ANTI HOAX &amp; PILKADA 2018 DAMAI	['ajar camat bilah hilir deklarasi anti hoaks amp pilih kepala daerah 2018 damai']	neutral
Bandara Udara Internasional Kertajati dibangun oleh Gubernur Ahmad Heryawan tanpa gunakan APBN pemerintah pusat. Insya Allah siap beroperasi bulan depan;	['bandara udara internasional ajati bangun gubernur ahmad heryawan anggar dapat belanja negara perintah pusat insya allah operasi']	positive
Ini si USER kerjaannya delay mulu! Setan!'	['sih kerja delay mulu setan']	negative
menurutku pintu sorga ada yaitu pintu sorga yang asli dan pintu hatimu modusbanget	['turut pintu sorga pintu sorga asli pintu hati modus banget']	negative
RT USER USER USER PKI hanya muncul jika jelang pemilihan kepala daerah dan pemilihan presiden krn digoreng sampai gosong.	['partai komunis indonesia muncul jelang pilih kepala daerah pilih presiden goreng gosong']	neutral
USER USER Itu mah sdh nenek-nenek sy heran sama cebong biasay bohong terus'	['nenek nenek heran cebong bohong']	negative
Dari habis sahur sampe jam 10. Sibayik udah nete 4x. Skg rasanya lemas tak terkira \xf0\x9f\xa4\xa2'	['habis sahur jam 10 si bayi nete kali lemas xf0 x9f xa4 xa2']	positive
USER Gak kak emak mah gak demen ama yang sipit wkwk'	['kak emak suka sipit wkwk']	negative
USER Ga kak, gua bukan orang jawa maaf yak :(; ; gua orang palembang soalnya, kakak aja deh yg belajar aksara jawa. Atau kalak mau belajar budaya palembang?,0,0,0,0,0,0,0,0,0,0,0,0;;;;;;;;;;;;	['kak gue orang jawa maaf ya gue orang palembang kakak deh ajar aksara jawa kelak ajar budaya palembang 0 0 0 0 0 0 0 0 0 0 0 0']	negative
Pegawai Guardian training lagi kek Mentang2 gue kek gembel cuman kaos sama Flat shoes nanya dijutekin bangsad emang males belinya juga kabur gua ke matahari'	['pegawai guardian training kayak mentang mentang gue kayak gembel kaos flat shoes dijutekin bangsat malas beli kabur gue matahari']	negative
\xe2\x80\x9dPara Bajingan yang telah melukai Lady harus menerima ganjaran seratus kali lipat!!\xe2\x80\x9d(sanji) ##HBD17thPelautJKT48'	['xe2 x80 x9dpara bajing luka lady terima ganjar ratus kali lipat xe2 x80 x9d sanji selamat ulang laut jkt48']	negative
ajakan menolak berita hoax dan sukseskan pilkada di wilayah kota keidri:	['aja tolak berita hoaks sukses pilih kepala daerah wilayah kota diri']	neutral
USER USER Presiden RI Jokowi luarBiasa kerja nya tulus IHLAs untuk #RakyatB3rsamaJKW	['presiden ri jokowi kerja nya tulus ikhlas rakyat jokowi']	positive
Edan emang goollnya fabiano!!'	['edan tuju fabiano']	neutral
GAPERNAH MENDALAMI AL-QURAN YA BANG??? PANTESAN MULUTNYA KAYA ORANG KAFIR BEJAT HINA farhatabbaslaw'	['dalam al alquran ya bang mulut kayak orang kafir bejat hina farhat abbas law']	negative
Sangat terlihat beda sekali Kewibawaannya ,; yg sangat berwibawa cuma gubernur Indonesia USER ; Massya Allah...,0,0,0,0,0,0,0,0,0,0,0,0;;;;;;;;;;;;	['beda wibawa wibawa gubernur indonesia masya allah 0 0 0 0 0 0 0 0 0 0 0 0']	negative
Anjir baru kali ini lihat orang bego mau debat pilkada. Kerjanya nyerang karakter. Shame on you mpok silvy and agus. #DebatFinalPilkadaJKT	['anjir kali lihat orang bego debat pilih kepala daerah kerja serang karakter kecewa on empok silvy and agus debat final pilih kepala daerah jakarta']	negative
"#GubernurZamanNow #GusIpulPuti2 #GanjarYasin1 #DjarotSihar2 #HasanAnton2 #KosterAce1 #NurdinSudirman3 #KarolinGidot2 RT USER: ""Keanekaragaman budaya, suku, agama, itulah sesungguhnya kekayaan kita,â?? tutur Djarot di hadapan peserta Rakercabsuâ?¦,0,0,0,0,0,0,0,0,0,0,0,0;;;;;;;;;;;;"	['gubernur zaman now gus ipul puti 2 ganjar yasin 1 djarot sihar 2 hasan anton 2 koster ace 1 nurdin sudirman 3 karolin gidot 2 keanekaragaman budaya suku agama sungguh kaya djarot hadap pese a rakercabsu 0 0 0 0 0 0 0 0 0 0 0 0']	neutral
USER USER positif kok.\nse-positif respon masyarakat terhadap\n- CANGKUL impor\n- GARAM impor\n- BERAS impor\n- JAGUNG impor\n- TENAGA KERJA impor\n- ESEMKA impor\n\nURL	['positif nse positif respon masyarakat cangkul impor garam impor beras impor jagung impor tenaga kerja impor esemka impor nurl']	positive
KAU PENDIKAN TINGGI TAPI BODOH....GK ADA LARANG BAWA AGAMA..BIAR ORANG ISLAM YG DI BAYAR AHOK SADAR GK JADI MILIH AHOK GLA	['didik bodoh larang bawa agama biar orang islam bayar ahok sadar pilih ahok gila']	negative
"USER Awaasss... Jgn sampe beritanya sampe ke akhi gerung! Ntar susah nyari kosakatany. klu bcr aja micingin mata, bibir monyong kesamping, suara keluar ky lg nhn kentut.. ""politik kotor skl jmn ini!"". Klu tahu brt ini.. Plng Sambil ky nhn ngeden..""dungu!"". \xf0\x9f\x98\x8b,1,1,1,0,0,0,1,0,0,1,0,0;;;;;;;;;;;;"	['awaasss berita saudara gerung susah cari kosakata bocor picing mata bibir monyong samping suara ky nhn kentut politik kotor zaman b pulang ky nhn ngeden dungu xf0 x9f x98 x8b 1 1 1 0 0 0 1 0 0 1 0 0']	negative
pinokio umur 3 taonan tuh. #2019GantiPresiden	['pinokio umur 3 tahun 2019 ganti presiden']	negative
RT USER benci sekali dgn Umat Islam	['benci umat islam']	negative
"USER USER USER ""Provokasi mayat, politisasi agama"" penyebab kekalahan pilkada DKI, beginilah cara cebong mendeskripsikan kekalahan junjungannya.; FYI ahog blm pernah ikut pemilihan apapun (kec jd wakil) dan dia bukanlah etnis mayorita,1,1,1,0,0,1,0,0,0,1,0,0;;;;;;;;;;;;"	['provokasi mayat politisasi agama sebab kalah pilih kepala daerah daerah khusus ibukota cebong deskripsi kalah junjung for your information ahok pilih apa camat wakil etnis mayoritas 1 1 1 0 0 1 0 0 0 1 0 0']	negative
USER dari pada gua nete'	['gue nete']	positive
USER Lol bani lowo'	['wkwk bani lowo']	positive
Takabur bisa lahir dari siapa saja. Penguasa, rakyat, ulama maupun cendikia. Bahkan iblis mahluq yg alim &amp; telah beribadah beratus2 th dilaknat krn hasud takabburnya. Apalagi hanya seorang ahli ilmu filsafat yg tdk failosof; ; Mari kita demo diri sendi,0,0,0,0,0,0,0,0,0,0,0,0;;;;;;;;;;;;	['takabur lahir kuasa rakyat ulama cendikia iblis makhluk alim amp ibadah atus ratus laknat hasud takabur ahli ilmu filsafat failosof mari demo sendi 0 0 0 0 0 0 0 0 0 0 0 0']	negative
[ SAMPAI KAPAN MAKAN RACUN ? ]; _; Banyak ulama yang mengatakan hukum rokok mubah dan ada jugaâ?¦	['makan racun ulama hukum rokok mubah']	negative
Susilo Bambang Yudhoyono Presiden RI ke 6 meminta Khofifah Emil untuk dekat dengan masyarakat . No 1 Bisa ! BaGusS #KhofifahEmilNomer1	['susilo bambang yudhoyono presiden ri 6 khofifah emil masyarakat no 1 bagus khofifah emil nomor']	neutral
Saya suka video USER URL Awal Kisah Perseteruan Haji Bolot &amp; Malih Tongtong'	['suka video uniform resource locator kisah seteru haji bolot amp malih tongtong']	neutral
"USER USER USER USER \xf0\x9f\x8e\xb6 la la la...hm hmm \xf0\x9f\x8e\xa7 ""Semua diam ,semua bisu""\n""Kita coba tanya sama rumput yg bergoyang"" \n\xe2\x99\xab\xe2\x99\xab\xe2\x99\xab\xe2\x99\xaa\xe2\x99\xaa\xe2\x99\xaa',0,0,0,0,0,0,0,0,0,0,0,0;;;;;;;;;;;;"	['xf0 x9f x8e xb6 hem hem xf0 x9f x8e xa7 diam bisu coba rumput goyang xe2 x99 xab xe2 x99 xab xe2 x99 xab xe2 x99 xaa xe2 x99 xaa xe2 x99 xaa 0 0 0 0 0 0 0 0 0 0 0 0']	negative
USER USER USER USER USER USER USER Klw ente atheis..ngapain sibuk dgn agama orang...	['ateis sibuk agama orang']	negative
Lengserkan Jokowi Bangsat!!	['lengser jokowi bangsat']	negative
USER Selamat hari kartini ; ; #2019GANTIPRESIDEN; #2019PRESIDENBARU	['selamat kakak 2019 ganti presiden 2019 presiden']	neutral
USER Iya cocot'	['iya cocot']	negative
USER karena budaya indonesia.	['budaya indonesia']	neutral
"USER Yang ngajarin solat'a ajah itu orang aseng dia hanya ingin memecah belah islam"",0,0,0,0,0,0,0,0,0,0,0,0;;;;;;;;;;;;"	['ajar salat a orang asing pecah belah islam 0 0 0 0 0 0 0 0 0 0 0 0']	negative
USER x || Lo ngomong aja kaga bener bangke'	['x bicara bangkai']	negative
USER USER Kita semua tidak pernah akan mempercayai yg negara Kita disuatu hari nanti akan dijajah oleh kerana terdapat kes2pembubaran sistem2 beraja dinegara Kita kini untuk menjadikan sebagai negara republik komunis padahal negara2 penjaja	['percaya negara jajah ranah bubar sistem sistem beraja negara jadi negara republik komunis negara negara jaja']	negative
tapi masih menikmati kebijakan yang dulu diusulkan PKI.. lha yo opo...	['nikmat bijak usul partai komunis indonesia iya']	positive
Kalo seumpama orang cina di usir paksa dari indonesia gimana	['umpama orang cina usir paksa indonesia']	negative
USER bunda ngentot yuk'	['bunda ngentot yuk']	neutral
RT USER: china babi... china maling...\n#UsirChina https:\/\/t.co\/9y4HIWHJp2	['cina babi cina maling usir cina hypertext transfer protocol over secure socket layer t co 9y4hiwhjp2']	negative
PROYEK KORUPSI REZIM SBY URL	['proyek korupsi rezim susilo bambang yudhoyono uniform resource locator']	neutral
AB: pribadi yg senang berkompetisi dalam hal yang baik dan positif	['ab pribadi senang kompetisi positif']	positive
USER USER Terus menurut lo kitab suci agAma apa yg di bilang om USER ; ; #Mendadakkalap	['kitab suci agama bilang om dadak kalap']	negative
USER Suka nutup mata. Kaga ditutup pun udah terlihat tertutup gara2 sipit /?'	['suka tutup mata tutup te utup gara gara sipit']	negative
USER eh kasar kau kampang'	['eh kasar kampang']	negative
"BENTAR LAGI GUA RILIS ALBUM THE ONTA'S WKWKWKWKWK"",0,0,0,0,0,0,0,0,0,0,0,0;;;;;;;;;;;;"	['bentar gue rilis album the onta si wkwk 0 0 0 0 0 0 0 0 0 0 0 0']	negative
USER Ada cebong bang dia merasa paling benar'	['cebong bang']	negative
Najis banget gw ngetwit apa barusan wey'	['najis banget gue mentwit barusan he']	positive
Kamu transgender atau gmn anjing :( URL	['transgender anjing uniform resource locator']	negative
USER awas bintitan lu ngintipin titit kucing'	['awas bintit intip titit kucing']	positive
Jgn salah target bkn ahok... agenda utama lengserkan Jokowi ..	['salah target ahok agenda utama lengser jokowi']	negative
USER USER masa baru kena hestek aja udah kepanasan ??? Kepo banget ; ; #2019GantiPresiden	['kena tagar panas banget 2019 ganti presiden']	negative
Prabowo Sudah Kalah Menyebut Bantuan Jokowi Hanya Pencitraan Adalah Ratapan Pilu	['prabowo kalah sebut bantu jokowi citra ratap pilu']	neutral
USER USER dan yang takut dengan adzan adalah IBLIS'	['takut azan iblis']	negative
USER USER Yg goblog itu adalah bani cebong tukang tipu penjilat penguasa yg ketahuan gerakin masa yg dibayar pakai nasi bungkus. Propaganda nasi bungkus memang selalu gagal.'	['goblok bani cebong tukang tipu jilat kuasa tahu gera bayar pakai nasi bungkus propaganda nasi bungkus gagal']	negative
USER USER USER USER Wuih... cebong sewot...\n\xf0\x9f\x98\x82\xf0\x9f\x98\x82\xf0\x9f\x98\x82'	['cebong sewot xf0 x9f x98 x82 xf0 x9f x98 x82 xf0 x9f x98 x82']	negative
2. Gerakan ini menekankan pentingnya kerja keras secara total untuk tingkatkan potensi bangsa	['2 gera tekan kerja keras total tingkat potensi bangsa']	negative
Padahal gubernur saat ini Djarot. Mayoritas partai politik di DPRD juga pendukung Ahok Djarot. Payah ya mereka USER URL	['gubernur djarot mayoritas ai politik dewan wakil rakyat daerah dukung ahok djarot payah ya uniform resource locator']	negative
USER Nah loh katanya anti aseng'	['anti asing']	negative
#AsyikM3nang saya sih ikut ulama saja	['asyik menang sih ulama']	positive
USER Yang saya ketahui bahwa diketapang banyak tka asing yg berkerja di berbagai perusahaan. Termasuk pt who tambang bouksid yg viral saat pilpres dulu. \nDan bisa jadi ini karena kerja sama tsb terjadi di era gubernur cornelis dan wakilnya ora	['tahu ketapang tenaga kerja asing asing usaha pt who tambang bauksit viral pilih presiden kerja era gubernur cornelis wakil']	neutral
USER Anak pecun... ga jauh2 dr hobi zina.. haha'	['anak pecun hobi zina haha']	negative
USER QUE BOM SBBSNSN'	['bom surat harga syariah negara']	neutral
USER Ian pantat'	['ian pantat']	negative
Pendaftaran Capres untuk #Pilpres2019 saja belum dibuka sampai Agustus 2018...yang normatif begini politikus PDIP masih belum paham? #2019GantiPresiden !!	['daftar calon presiden pilih presiden 2019 buka agustus 2018 normatif politikus partai demokrasi indonesia juang paham 2019 ganti presiden']	neutral
Si tolol udah tau pemerintah rezim komunis ini bobrok koruptor bisa pimpinan sidang DPR paya cebong URL	['sih tolol tau perintah rezim komunis bobrok koruptor pimpin sidang dewan wakil rakyat paya cebong uniform resource locator']	negative
dari dulu kenapa bapak w kalau ke mantan mantan w selalu mgerasa sedih ampe kepikiran dan gabisa tidur lohh?!! dan w ngerasa jadi anak yg brengsek aja gt ke laki2 :)))'	['gue mantan mantan gue sedih pikir tidur lo gue anak berengsek laki laki']	negative
Cina perusak bangsa!! Usir !! Stuju??	['cina usak bangsa usir tuju']	negative
#2019GantiPresiden scra konstitusional hak setiap rakyat woiii!! . Gini nih kalo planga plongo tapi kelakuan otoriter.	['2019 ganti presiden konstitusional hak rakyat woiii nih plonga plongo laku otoriter']	neutral
Mari kita wujudkan Pilkada Kota Bengkulu 2018 aman dan damai.; .; .; coki_adem86 98heruâ?¦	['mari wujud pilih kepala daerah kota bengkulu 2018 aman damai cok adem86 98heru']	negative
KORSA: Pernyataan Moeldoko Bukti Istana Takut dengan Kebangkitan Umat Islam	['sama nyata moeldoko bukti istana takut bangkit umat islam']	negative
cowo yang jago drasex mana? sini ngentot sama adek - luvian'	['cowok jago drasex ngentot adik luvian']	negative
USER USER loh bukan nya mentri suharto ada yg homo?'	['nya menteri suha o homo']	negative
Gue tau loh bukan yang dulu yang masih culun dan cemen semua orang pasti akan berubah perlahan2 entah itu baik / buruk :)'	['gue tau culun takut orang ubah perlahan lahan buruk']	negative
Pada perang salib dulu itu kerajaan di Afrika terbagi dua yakni Babilonia pemeluk kristen dan Tobaco pemeluk islam'	['perang salib raja afrika bagi babilonia peluk kristen tobaco peluk islam']	negative
Moga ini ada tindak lanjutnya!; ; Pelaporan terhadap ?penista agama? Ade Armando akan dilakukan langsung oleh Ketua Umum FPI KH. Shobri Lubis ke Bareskrim Mabes Polri, Gambir, Jakarta Pusat pada Selasa (10/4) pukul 13.00 WIB.; #Perhaps USER;,1,0,1,0,1,0,0,0,0,1,0,0;;;;;;;;;;;;	['moga tindak lapor nista agama adek armando langsung ketua front bela islam kh shobri lubis badan reserse kriminal markas polisi republik indonesia gambir jaka a pusat selasa 10 4 13 00 indonesia barat perhaps 1 0 1 0 1 0 0 0 0 1 0 0']	neutral
USER USER USER USER USER USER USER USER Bangke.. hajar!!!!'	['bangkai hajar']	negative
USER USER USER .\nOnta mati klo kebanyakan Minum'	['onta mati banyak minum']	negative
URL Ahok tng mrka trus was-was hdpnya USER USER USER USER USER USER USER	['uniform resource locator ahok tng was was hidup']	positive
Itu baru di Sul Teng.. !!!; Ini ekses akibat tersandera hutang china !!!; #2019GantiPresiden; #2019PresidenBaru ; #2019TetapJokowiGanti	['sul teng ekses akibat sandera hutang cina 2019 ganti presiden 2019 presiden 2019 jokowi ganti']	neutral
6. Pride (Yunani; \xe1\xbd\x99\xcf\x80\xce\xb5\xcf\x81\xce\xb7\xcf\x86\xce\xb1\xce\xbd\xce\xaf\xce\xb1-hyper\xc4\x93phania) keangkuhan/harga diri/kesombongan\ndikenal juga dengan sebutan hubris/vanity. harga diri yang tinggi dapat merubah manusia sombong, kesombongan membuat manusia terkutuk dimata tuhan.dan dapat membuat manusia mencintai dirinya sendiri-',0,0,0,0,0,0,0,0,0,0,0,0;;;;;;;;;;;;	['6 pride yunani xe1 xbd x99 xcf x80 xce xb5 xcf x81 xce xb7 xcf x86 xce xb1 xce xbd xce xaf xce xb1 hyper xc4 x93phania angkuh harga sombong kenal sebut hubris vanity harga ubah manusia sombong sombong manusia kutuk mata tuhan manusia cinta 0 0 0 0 0 0 0 0 0 0 0 0']	negative
USER Tak hanya kurang bertaji nya kpk era ini...tapi era ini juga komitmen dlm pemberantasan korupsi tdk spt di era Pak sby....	['be aji nya komisi berantas korupsi era era komitmen berantas korupsi surat pemberitahuan tahun era susilo bambang yudhoyono']	neutral
RT USER: Admin tolol di partai tolol\nPartai Tolol untuk orang Tolol'	['admin tolol ai tolol ai tolol orang tolol']	negative
Video ttg TKA dibuat oleh Malaysia tapi mengutip pernyataan saya di USER	['video tenaga kerja asing malaysia kutip nyata']	neutral
PPP: Jangan Buru-buru Tolak Wacana Pilkada LewatÂ DPRD	['ppp buru buru tolak wacana pilih kepala daerah dewan wakil rakyat daerah']	neutral
"Random pagi2 ada Bapak2 nyamperin ke meja kerja trus nanya ""pake bedak apa sih biar mukanya bersih, istri saya butek soalnya""\nIngin ku jawab pake air wudhu tapi ku Kristen.',0,0,0,0,0,0,0,0,0,0,0,0;;;;;;;;;;;;"	['random pagi pagi samper meja kerja pakai bedak sih biar muka bersih istri butek ku pakai air wudhu ku kristen 0 0 0 0 0 0 0 0 0 0 0 0']	negative
USER USER KO GUA KAMPRET'	['gue kampret']	negative
Memek lonte pengen disodok kontol gede'	['memek lonte sodok kontol gede']	negative
Jokowi aja yg mundur. USER tutup. URL	['jokowi mundur tutup uniform resource locator']	neutral
USER Ada amin rasis.\nAda amat dani\nAda ratna si paiiit.\nAda si onta.\nAda si lobang anus.\nJdi jngan takut wo wo..\nKehabisan obat penenang yh.'	['amin racist nada dan nada ratna sih paiiit nada sih onta nada sih lobang anus takut oi oi habis obat tenang ya']	negative
USER Tunggu komando IMAM BEJAT CABUL USER . TAIK BEER \xf0\x9f\x8d\xba\n\nApe2 bawa ULAMA...\nDASAR Banj SEMPAK'	['tunggu komando imam bejat cabul tai bir xf0 x9f x8d xba bawa ulama dasar banj sempak']	negative
Kabinet berantakan \nPemecah belah persatuan hanya ad di rezim ini'	['kabinet beranta pecah belah satu rezim']	negative
USER USER ga caya sama mulut buaya mu bwang'	['percaya mulut buaya mu bawang']	positive
2019, jika SBY + PRABOWO menyatu melawan MEGA + JOKOWI , maka peristiwa 2004 akan terulang dimana PDIP yg Incumbent dikalahkan mutlak oleh SBY. ; ; Tp jk JKW+MEGA+SBY melawan PRABOWO, mk Pilpres selesai sudah. ; ; Jk 3 Poros di Pilpres, mk salah satu Lawan,0,0,0,0,0,0,0,0,0,0,0,0;;;;;;;;;;;;	['2019 susilo bambang yudhoyono prabowo satu lawan mega jokowi peristiwa 2004 ulang mana partai demokrasi indonesia juang incumbent kalah mutlak susilo bambang yudhoyono jokowi mega susilo bambang yudhoyono lawan prabowo mk pilih presiden selesai 3 poros pilih presiden mk salah lawan 0 0 0 0 0 0 0 0 0 0 0 0']	neutral
RT USER USER Jangan kayak BANCI KALENG kamu GATOT sering buat Gaduh gentleman lah MUNDUR siap bersaing di pemilihan presidens 2019 melawan Jokowi	['kayak banci kaleng gatot gaduh gentleman mundur saing pilih presiden 2019 lawan jokowi']	positive
bebal...	['bebal']	negative
5. Yang terakhir karena Indonesia negara dengan populasi muslim terbesar di dunia, yang mana Islam saat ini merupakan musuh barat &amp; Komunis karena dapat menghambat agenda dan kepentingan mereka.(Obviously)',0,0,0,0,0,0,0,0,0,0,0,0;;;;;;;;;;;;	['5 indonesia negara populasi muslim besar dunia islam musuh barat amp komunis hambat agenda penting obviously 0 0 0 0 0 0 0 0 0 0 0 0']	negative
USER USER umuh &gt; persib\npersib kunyuk!!!!\n\xf0\x9f\x98\x82\xf0\x9f\x98\x82\xf0\x9f\x98\x82'	['umuh persib persib kunyuk xf0 x9f x98 x82 xf0 x9f x98 x82 xf0 x9f x98 x82']	positive
USER USER Buat film muslim pilih ahok mati nggak di sholatin......; dijamin laris ......	['film muslim pilih ahok mati salat jamin laris']	negative
"tapi banu banu Yahudi itu tentu beda dgn banu banu Kristen Syriac. salah satu perbedaan ad banu Yahudi tetep pake ""eloah/ elohim/ yahwe/"" sedangkan Syriac sudah pake ""alah/ allah""',0,0,0,0,0,0,0,0,0,0,0,0;;;;;;;;;;;;"	['banu banu yahudi beda banu banu kristen suriah salah beda banu yahudi pakai eloah elohim yahwe suriah pakai alah allah 0 0 0 0 0 0 0 0 0 0 0 0']	negative
USER Eh kenapa muka merah2 tu? Tak dpt cendol ke? Bukan la setan cuaca skrg ni panas.'	['eh muka merah merah cendol setan cuaca nih panas']	negative
Pemberitaan saracen diframing katak seakan tim prabowo dan anies-sandi. Seberulnya itu media menumpahkan sakit hati katak dan cebong. *Ehe	['berita saracen diframing katak akan tim prabowo anies sandi media tumpah sakit hati katak cebong ehe']	negative
Syg bgt ya ngeliat perempuan kyk gini... Gak ada status apa2 tp udah nemplok sm laki-laki sana sini. Haduh....\nNagita Slavina Blak-blakan Sebut Ayu Ting Ting Kampungan \xe2\x80\x93 VIVA URL	['sayang banget ya perempuan kayak status tempel laki laki aduh nagita slavina blak blak ayu ting ting kampung xe2 x80 x93 viva uniform resource locator']	negative
USER Jgn lupa juga kang.... Umat katolik dan minorutas lainnya diperhatika. Gubernur untuk semua golongan bukan satu golongan.'	['lupa kang umat katolik minoritas perhati gubernur golong golong']	positive
USER USER USER USER Kan ane bukan cebong udeh dibilangin dari maren masih ngeyel\nSitu maksa ane jadi cebong?'	['cebong bilang kemarin eyel situ paksa cebong']	negative
USER wakakakaka aku sudah mengalaminya \xf0\x9f\x98\x82\xf0\x9f\x98\x82\xf0\x9f\x98\x82\xf0\x9f\x98\x82 tetiba muncul grub wa a.n Bani Abd Hadi a.k.a mbahku dan seketika aku mek kenal beberapa orang saja \xf0\x9f\xa4\xa3\xf0\x9f\xa4\xa3\xf0\x9f\xa4\	['wkwk alam xf0 x9f x98 x82 xf0 x9f x98 x82 xf0 x9f x98 x82 xf0 x9f x98 x82 muncul grub wa a bani abdi had a k a mbah mek kenal orang xf0 x9f xa4 xa3 xf0 x9f xa4 xa3 xf0 x9f xa4']	neutral
â??Seorang anak Pekan telah mengilhamkan Dasar Ekonomi Baru (DEB) dan menjadi penggerak utama kepada kemajuan ekonomi luar bandar. Beliau adalah Allahyarham Tun Abdul Razakâ?? - DS USER #MalaysiaMemilih #HogohUndi	['anak pekan ilham dasar ekonomi deb gerak utama maju ekonomi bandar beliau allah ya rahman tun abdul razak ds malaysia pilih hogohundi']	negative
USER USER Hahaha sialaaan nih si USER,; ; ternyata klo lg laper, ; presiden juga mau disikat sama doið???ð??½; ;,0,0,0,0,0,0,0,0,0,0,0,0;;;;;;;;;;;;	['haha sialaaan nih sih lapar presiden sikat 0 0 0 0 0 0 0 0 0 0 0 0']	negative
USER tahun 2019 Rakyat makan ASPAL dan BETON; ini adalah solusi jitu mengurangi kemiskinan; ; KEAHLIAN CEBONG HANYA 1, TUKANG TIPU !!!; cebong mah gitu, goblok nggak ketulungan. Plonga plongo mengakibatkan optimisme berlebihan; ; #2019GantiPresiden #,1,1,0,1,0,0,0,0,1,0,1,0;;;;;;;;;;;;	['2019 rakyat makan aspal beton solusi jitu kurang miskin ahli cebong 1 tukang tipu cebong goblok ketulungan plonga plongo akibat optimisme 2019 ganti presiden 1 1 0 1 0 0 0 0 1 0 1 0']	negative
"USER Aku pernah sempat baca ttg Harun Yahya ini yg 'membelot' ke kubu Yahudi dgn Freemasonry nya...kdg suka ga percaya..."",0,0,0,0,0,0,0,0,0,0,0,0;;;;;;;;;;;;"	['baca harun yahya belot kubu yahudi freemason nya kadang suka percaya 0 0 0 0 0 0 0 0 0 0 0 0']	negative
Kita Maju Bersama Ulama ; Kita Bergerak Bersama Semua Tokoh Agama untuk Indonesia; #NderekGusMus	['maju ulama gerak tokoh agama indonesia gus mus']	negative
USER USER USER USER USER USER USER USER USER USER USER USER USER USER USER USER USER USER USER USER USER	['']	negative
#MukidiKepedean ; Pertanyaan mudah ya..; Dijawab yg keras , tapi Saya minta dijawab yg keras , siapa nama Saya ?,0,0,0,0,0,0,0,0,0,0,0,0;;;;;;;;;;;;	['mukidi percaya pe anyaan mudah ya keras keras nama 0 0 0 0 0 0 0 0 0 0 0 0']	negative
USER Kemarin di hujat sekarang mengharap dasar para bani kamprey'	['kemarin hujat harap dasar bani kampret']	negative
Body Lufra/ scrub dg bhn dasar lidah buaya utk mlembabkn kulit &amp; lbh bcahaya info: 087812026394 #BMI'	['body lufra scrub bahan dasar lidah buaya melembabkan kulit amp cahaya info 087812026394 body mass index']	neutral
USER Tak punya cacat di masa lalu krn blum bermasa lalu'	['cacat masa']	negative
USER USER jangan2 penganut bumi datar juga? \xf0\x9f\x98\x9d\nsoalnya teori bumi bulat kan dari orang asing yg notabane musuh mereka.'	['anut bumi datar xf0 x9f x98 x9d teori bumi bulat orang asing notabene musuh']	negative
Becak Warga Binjai Hendak Disita karena Gunakan Tenda Bertuliskan #2019GantiPresiden, PKS MERADANG; ; Bukti pemerintah panik dan takut?; ;,1,0,0,1,0,0,0,0,1,0,1,0;;;;;;;;;;;;	['becak warga binjai sita tenda be uliskan 2019 ganti presiden partai adil sejahtera radang bukti perintah panik takut 1 0 0 1 0 0 0 0 1 0 1 0']	negative
lebih baik jokowi mundur..	['jokowi mundur']	neutral
Munas Alim Ulama PPP di semarang. menghasilkan lima rekomendasi syarat dan kriteria-kriteria bagi Calon Wakil Presiden yang akan mendampingi Bpk Jokowi di 2019 mendatang. #Romahurmuziy	['musyawarah nasional alim ulama ppp semarang hasil rekomendasi syarat kriteria kriteria calon wakil presiden damping jokowi 2019 romahurmuziy']	neutral
USER Luar biasa pencerahan nya.. Saya merasa gagal sebagai anak ekonomi.. Wkwk	['cerah nya gagal anak ekonomi wkwk']	positive
Oleh rezim skrg atas kendali Negara Cina Komunis yg mjd patron tunggal rezim anti islam ( Jokowi )	['rezim kendali negara cina komunis patron tunggal rezim anti islam jokowi']	negative
USER USER itu tanda nya mau pilkada n pilpres	['tanda nya pilih kepala daerah pilih presiden']	neutral
Misi4: Membangun masyarakat yang gotong royong toleran dan harmoni selaras nilai budaya Jawa Barat yang luhur #No3JabarAsyik #Asyikm3nang	['misi 4 bangun masyarakat gotong royong toleran harmoni selaras nilai budaya jawa barat luhur nomor jawa barat asyik asyik menang']	positive
Ketabahan pasangan En Taufiq dan Puan Nurliyana yang wajar dicontohi.. jom kita beri sumbangan untuk meringankan beban pasangan ini... come on twitter do your things! ; ; BSN - 0510541000096745 ; Bank Islam - 05058020145124 ; (Nurliyana bte Abdul Raziff) ;	['tabah pasang taufik puan nurliyana wajar contoh jom sumbang ringan beban pasang come on twitter do your pikir badan standar nasional 0510541000096745 bank islam 05058020145124 nurliyana bosan abdul razif']	negative
USER USER celeng kgn gw y'	['celeng kangen gue iya']	negative
#TerangiNegeri dengan budaya , yuk pada visit ke purwokerto ,mumpung Ada even rakyat.; .; #purwokerto; #extravaganzabanyumas,0,0,0,0,0,0,0,0,0,0,0,0;;;;;;;;;;;;	['rang negeri budaya yuk unjung purwoke o mumpung even rakyat purwoke o ekstra vaganza banyumas 0 0 0 0 0 0 0 0 0 0 0 0']	neutral
USER Aamiin ya Allah :(((\nTimnya Kinan aja sampai pelatihan ular karena dia dapat di rawa-rawa. Aku dapatnya di sungai gede gt dan musuhnya buaya wkwkw'	['amin ya allah tim kan latih ular rawa rawa dapat sungai gede musuh buaya wkwk']	neutral
USER USER MAJU KAMU NGATAIN MAMA AKU BOLOT'	['maju maki mama bolot']	negative
USER USER USER Segitu gentarnya dia takut terhadap Kafir...\xf0\x9f\x98\x81'	['gentar takut kafir xf0 x9f x98 x81']	negative
RT USER USER betul padahal saracen juga siapa sehingga akun yang kritis dianggap saracen kan aneh jokowi	['saracen akun kritis anggap saracen aneh jokowi']	negative
USER siapa bego lu bukan tmn gua najis dah kesel sendiri gue'	['bego teman gue najis kesal gue']	negative
USER USER Kafir kristen selalu buat ulah	['kafir kristen ulah']	negative
USER Anjir serem maennya begituan \xf0\x9f\x98\x82\xf0\x9f\x91\x8c'	['anjir seram main begitu xf0 x9f x98 x82 xf0 x9f x91 x8c']	negative
USER Kayaknya bisa? Atau cuma bank tertentu? Bilang aja mau jual uang asing/tukar ke rupiah'	['kayak bank te entu bilang jual uang asing tukar rupiah']	neutral
USER USER USER USER Onta yaman ni\n\nsetahun lagi gua deportasi loe'	['onta yaman nih tahun gue depo asi']	negative
Hati-Hati Berita Pilkada yang Berbau Hoax #madiun #madiuntoday #100thmadiun #KotaKarismatikMadiun #tolakcukaiilegal; Kunjungi juga	['hati hati berita pilih kepala daerah bau hoaks madiun madiun today 100thmadiun kotak karismatik madiun tolak cukai ilegal kunjung']	neutral
USER anak cocot ya ini USER'	['anak cocot ya']	negative
USER \xf0\x9f\x99\x88\xf0\x9f\x99\x88\xf0\x9f\x99\x88\xf0\x9f\x99\x88\xf0\x9f\x99\x88\xf0\x9f\x99\x88\xf0\x9f\x99\x88udah ketauan HOAX ya Fahri mangkanye klu ambil berite tuyg update jangan dari tong sampah diambil terus di SS taunya berit udah	['xf0 x9f x99 x88 xf0 x9f x99 x88 xf0 x9f x99 x88 xf0 x9f x99 x88 xf0 x9f x99 x88 xf0 x9f x99 x88 xf0 x9f x99 x88udah tahu hoaks ya fahri ambil berita tuyg baru tong sampah ambil screenshoot tau berita']	negative
Mantaaap DM dekat sama Banser bang USER	['mantap direct message baris serba bang']	negative
USER USER Pantas indonesia mundur dalam segala bentuk	['indonesia mundur bentuk']	neutral
USER USER USER USER Naahh yg dongo yg bilang hekell hahaha'	['dongok bilang hacker haha']	negative
USER USER USER USER Hahahaha blunder lu cebong... Yg gak ngasih tuh pem. pusat dengan Alasan HAM... kalau rakyat aceh ya mau kali pun.. Cobak kau datangi pemerintah bilang suruh buat hukum islam kaffah di aceh... Klau DPR a	['haha blunder cebong protein energy malnutrition pusat alas ham rakyat aceh ya kali coba datang perintah bilang suruh hukum islam kaffah aceh dewan wakil rakyat a']	negative
BANGSAD GUA DAH NYELEM AMPE BAWAH2 BALIK LGI KE ATAS!1!'	['bangsat gue selam 1']	negative
Saya tak bisa dipancing-pancing dgn urusan penistaan atau bukan. Saya hanya berbicara pemahaman saya ttg fiksi dan kitab suci.	['pancing pancing urus nista bicara paham fiksi kitab suci']	negative
USER USER USER USER Cebong kacung itu kt temen gw dungunya sampe ke tulang sum2..jd jgn buang2 energi debat sm mereka..\xf0\x9f\x98\x82'	['cebong kacung teman gue dungu tulang sumsum buang buang energi debat xf0 x9f x98 x82']	negative
USER PARTAI KORUPSI SAPI......goblog...'	['ai korupsi sapi goblok']	negative
USER USER Matane aku moh aku kafir wkwkwk'	['mata kafir wkwk']	negative
USER Jadi inget fesbuk anjir lupa aku'	['facebook anjir lupa']	neutral
"USER kalo aing sih bakal bilang ""hilih kntl""',0,1,0,0,0,0,0,0,0,0,0,0;;;;;;;;;;;;"	['sih bilang alah kontol 0 1 0 0 0 0 0 0 0 0 0 0']	negative
Lahir dan berkembangnya gerakan komunis di Indonesia tidak dapat dipisahkan dari sebuah organisasi yg bernama ISDV'	['lahir kembang gera komunis indonesia pisah organisasi nama indische sociaal democratische vereeniging']	neutral
Shaheizy Sam wajah baharu Calpis	['shaheizy wajah baharu calpis']	negative
"""Ya, terserah lo aja."" Balasnya kembali fokus kepada kerjaan kita.; ; Kami mengerjakan tugas project Seni Budaya hanya dalam 2 hari, setelahnya langsung dikumpul dan dipresentasikan. Bersyukur nilainya memuaskan.; ; Setelah kejadian project itu kami makin,0,0,0,0,0,0,0,0,0,0,0,0;;;;;;;;;;;;"	['ya serah balas fokus kerja tugas proyek seni budaya 2 telah langsung kumpul presentasi syukur nilai muas jadi proyek 0 0 0 0 0 0 0 0 0 0 0 0']	negative
Ga bakalan bro	['bro']	negative
KELAKUAN bodoh USER masuk KATEGORI perbuatan TIDAK MENYENANGKAN\n\nKelakuan sontoloyo USER sangat MENGANGGU persatuan BANGSA\n\nKelakuan NAIF USER secara TIDAK LANGSUNG sbg bentuk INTIMIDASI thd ULAMA\n\nKelakuan USER	['laku bodoh masuk kategori buat senang laku sontoloyo menganggu satu bangsa laku naif langsung bentuk intimidasi ulama laku']	positive
Monyet Turun ke Pemukiman Warga Cibadak Sukabumi - URL	['monyet turun mukim warga cibadak sukabumi uniform resource locator']	negative
mau giveaway taplak meja tapi nanti yang menang cuma therichchenle'	['giveaway taplak meja menang the rich chenle']	neutral
RT USER: Sudah kebuka satu demi satu kebusukab kubu anies sandi yg menang dengan tanpa berkah URL dan Prabowo berusaha cuci tangan	['buka busuk kubu anies sandi menang berkah uniform resource locator prabowo usaha cuci tangan']	negative
USER USER WKWKWKWK BODO BANG'	['wkwk bodoh bang']	negative
KLHK Upayakan Pemerataan Ekonomi Melalui TORA di Kawasan Hutan dan Perhutanan Sosial - Tribun Medan	['menteri lingkung hidup hutan upaya perata ekonomi tora kawasan hutan hutan sosial tribun medan']	neutral
USER USER Orang2 bego kebanyakan minum &amp; makan kotoran onta ...otak nya somplak'	['orang orang bego banyak minum amp makan kotor onta otak nya somplak']	negative
Apa yang terkuak semuanya sudah jelas sejak awal memang itu strategi kampanye kami di tim pemenangan anies sandi URL	['kuak strategi kampanye tim menang anies sandi uniform resource locator']	neutral
"""Warga Baduy setelah selesai memperingati tradisi Seba di Pendopo Pemkab Lebak akan dilanjutkan kembali bertemu dengan Gubernur Banten Wahidin Halim hari ini, Sabtu (21/4) #SebaBaduy2018"",0,0,0,0,0,0,0,0,0,0,0,0;;;;;;;;;;;;"	['warga badui selesai ingat tradisi seba pendopo perintah kabupaten lebak lanjut be emu gubernur banten wahidin halim sabtu 21 4 seba baduy 2018 0 0 0 0 0 0 0 0 0 0 0 0']	negative
Lembaga2 anti-korupsi masa lalu bubar krn sentuh kekuasaan. Giliran KPK kenapa PDIP partai politik penguasa yg plg ngotot ingin bubarkan KPK?	['lembaga lembaga anti korupsi bubar sentuh kuasa gilir komisi berantas korupsi partai demokrasi indonesia juang ai politik kuasa pulang otot bubar komisi berantas korupsi']	negative
USER USER USER Justru mas klo mnyudutkan salah satu agama trtentu malah bahaya,itulah pak rocky ini cerdik. Dia bisa nyusun kalimat yg tepat &amp;pantas dgunakan,Inti dari ini dia mau kasih tau pngertian fiksi sbenarnya,ayolah mas nya i,0,0,0,0,0,0,0,0,0,0,0,0;;;;;;;;;;;;	['mas sudut salah agama t entu bahaya rocky cerdik susun kalimat amp inti kasih tau pnge ian fiksi ayo mas nya i 0 0 0 0 0 0 0 0 0 0 0 0']	negative
Para Pendukung Capres gagal Move On salalu sibuk Urus Aseng bawa kabur uang Rp 35 T. Tapi ngak sadar kenapa Aseng bisa kabur bawa uang sebanyak itu tanpa didukung Pribumi ASU. Mustahil Aseng bisa. Pribumi hanya diam kalau disogok. Mental kacung emang. URL	['dukung calon presiden gagal pindah on sibuk urus asing bawa kabur uang rupiah 35 t sadar asing kabur bawa uang dukung pribumi anjing mustahil asing pribumi diam sogok mental kacung uniform resource locator']	negative
RT USER: USER USER Lo rabun apa budek?\nGue nulis gak ngomong!!\n\xf0\x9f\x98\x81\xf0\x9f\x98\x80'	['rabun budek gue tulis bicara xf0 x9f x98 x81 xf0 x9f x98 x80']	neutral
Bismillah nahan sepo yang terkutuk'	['bismillah tahan sepo kutuk']	positive
ARTINYA APA ? Pribumi sadari & lihat siapa mereka ? KECUALI KALIAN sama-sama CINA KOMUNIS / MISIONARIS abaikan tweet ini usir cina Indonesia	['a inya pribumi sadar lihat kecuali cina komunis misionaris abai twit usir cina indonesia']	negative
Presiden yang anda tuduh Rezim anti Islam sudah banyak berbuat untuk Negeri ini sudah bnyak berbuat untuk umat... URL	['presiden tuduh rezim anti islam buat negeri buat umat uniform resource locator']	negative
USER USER Manusia bangsad -.-'	['manusia bangsat']	negative
RT USER Tpi ingat ya. Jangan sampe Cina mengenalkan wisata Haram jga ke indonesia hahaha	['ya cina kenal wisata haram indonesia haha']	negative
RT USER Nanya di mana Prabowo dan PKS saja Bib kan asoy tuh dianggap antek Prabowo dan antek PKS. Hidupmu pasti lebih dramatis	['prabowo partai adil sejahtera bib asyik anggap antek prabowo antek partai adil sejahtera hidup dramatis']	positive
Persahabatan Salah-Lovren ini jadi bukti bahwa beda suku, agama, ras, bukanlah halangan dlm membina hubungan dgn sesama umat manusia.; ; Perbedaan justru menjadi warna tersendiri dlm menjalin pertemanan. Terima kasih, Lovren-Salah! â?¥ï¸? #Favourites #BFF #Bro,0,0,0,0,0,0,0,0,0,0,0,0;;;;;;;;;;;;	['sahabat salah lovren bukti beda suku agama ras halang bina hubung umat manusia beda warna sendiri jalin pe emanan terima kasih lovren salah favorit best friend forever bro 0 0 0 0 0 0 0 0 0 0 0 0']	negative
"Hello warga Jakarta, Wakil Kepala DPMPTSP Provinsi DKI Jakarta, Bapak Denny Wahyu Haryanto mewakili Wakil Gubernur Provinsi DKI Jakarta membuka acara ""2018 Junior Chamber International (JCI) Indonesia National Event"" #setiamelayanijakarta,0,0,0,0,0,0,0,0,0,0,0,0;;;;;;;;;;;;"	['halo warga jaka a wakil kepala dinas tanam modal layan padu pintu provinsi daerah khusus ibukota jaka a denny wahyu haryanto wakil wakil gubernur provinsi daerah khusus ibukota jaka a buka acara 2018 junior chamber international jci indonesia nasional event setiamelayanijaka a 0 0 0 0 0 0 0 0 0 0 0 0']	neutral
Pandangan TGB terhadap Agama dan Politik	['pandang tuan guru bajang agama politik']	negative
RT USER: Provider brengsek'	['sedia berengsek']	positive
Susilo Bambang Yudhoyono Presiden RI ke 6 meminta Khofifah Emil untuk dekat dengan masyarakat . No 1 Bisa ! #BaGusS	['susilo bambang yudhoyono presiden ri 6 khofifah emil masyarakat no 1 bagus']	neutral
USER USER USER Yang dungu itu orang yang mau ganti presiden!!! Tp g tau siapa!!! Mikiiiir!!!!'	['dungu orang ganti presiden tau mikiiiir']	negative
RT USER: Bokep cewek bispak bandung ngentot Croot Di Dalam \xf0\x9f\x98\x80\n\nDownload Full : URL URL	['bokep cewek bispak bandung ngentot crot xf0 x9f x98 x80 unduh full uniform resource locator uniform resource locator']	negative
USER kampret complain rag ditanggepi fuck'	['kampret complain raga tanggap fuck']	negative
Kamu kok kaya jablay GTA maunya dijemput pake mobil'	['kayak jablay grand theft auto mau jemput pakai mobil']	negative
Lihat memek tante'	['lihat memek tante']	positive
Sementara itu USER kerjanya musuhi dakwah Islam & bubarkan HTI..! Rakyat jg berhak lengserkan jokowok tukang pencitraan!!	['kerja musuh dakwah islam bubar hati rakyat hak lengser jokowi kodok tukang citra']	negative
USER USER USER USER USER USER USER USER USER USER USER USER USER USER USER USER USER USER dia doyan nete un jadi maklumin'	['suka nete uji nasional maklum']	neutral
USER nek ndelok match terkhir celsi sih kudune menang mudah emyu... Tapi yo embuh sih celsi kacrut ki raiso diprediksi \xf0\x9f\x98\x82'	['nek lihat match chelsea sih menang mudah manchester united iya embuh sih chelsea kacrut ki prediksi xf0 x9f x98 x82']	positive
USER Yakali Pak TNI suruh urusin sampah plastik... \xf0\x9f\x98\x91'	['ya kali tentara nasional indonesia suruh urus sampah plastik xf0 x9f x98 x91']	negative
"Permadi Arya melaporkan Rocky Gerung ke polisi? Serius tuh? ; ; ""Kitab suci itu fiksi,"" kata Rocky.; ; Pernyataan itu salah? Anda merasa terhina? Wait. Bukankah biasa penganut agama A menganggap kitab suci...,0,0,0,0,0,0,0,0,0,0,0,0;;;;;;;;;;;;"	['madi arya lapor rocky gerung polisi serius kitab suci fiksi rocky nyata salah hina tunggu anut agama a anggap kitab suci 0 0 0 0 0 0 0 0 0 0 0 0']	negative
USER bajingan tengik memang'	['bajing tengik']	negative
Kok bs pake buruh Cina? Kan rakyat sendiri bnyak pngangguran.Dasar rejim kodok!	['pakai buruh cina rakyat anggur dasar rejim kodok']	negative
USER USER USER USER USER USER USER USER USER USER USER USER USER USER USER USER USER USER USER USER @	['']	negative
rp haneul pada cute padahal rlnya perek.yang on retweet'	['rupiah haneul cute pacar perek on retweet']	neutral
USER Di suriah sekolah radikal dan rakit bom..plg ke indonesia jadi tempat pkl...ya di amankan'	['suriah sekolah radikal rakit bom pulang indonesia ya aman']	negative
USER Ih banci selotipan \xf0\x9f\x98\x82'	['ih banci selotipan xf0 x9f x98 x82']	negative
RT USER USER USER USER USER USER USER Haha kalah ni yee org jahat pasti kalah	['haha kalah nih iya orang jahat kalah']	negative
"#GubernurZamanNow #GusIpulPuti2 #GanjarYasin1 #DjarotSihar2 #HasanAnton2 #KosterAce1 #NurdinSudirman3 #KarolinGidot2 RT USER: ""Keanekaragaman budaya, suku, agama, itulah sesungguhnya kekayaan kita,â?? tutur Djarot di hadapan peserta Rakercabsuâ?¦,0,0,0,0,0,0,0,0,0,0,0,0;;;;;;;;;;;;"	['gubernur zaman now gus ipul puti 2 ganjar yasin 1 djarot sihar 2 hasan anton 2 koster ace 1 nurdin sudirman 3 karolin gidot 2 keanekaragaman budaya suku agama sungguh kaya djarot hadap pese a rakercabsu 0 0 0 0 0 0 0 0 0 0 0 0']	neutral
RT USER: USER Yg cinta orba pasti meng idola kan prabowo &amp; hary tanoe :D	['cinta orde meng idola prabowo amp hary tanoe']	positive
"Nantang buka Dadalah, eh nyebut Setanlah emang sudah pada habis Kamus ngelawan ""Kenegarawanan Pak Joko Widodo Presiden RI ke 7, pada makin Stresssssss nie hati2 kena Stoke atau Serangan Jantung nanti Rakyat Indonesia kehilangan Badut2 Politik"" MERDEKA.,1,1,0,1,0,0,1,0,0,0,1,0;;;;;;;;;;;;"	['tantang buka dada eh sebut setan habis kamus lawan kenegarawanan joko widodo presiden ri 7 stresssssss nih hati hati kena strok serang jantung rakyat indonesia hilang badut badut politik merdeka 1 1 0 1 0 0 1 0 0 0 1 0']	negative
"USER USER USER USER ""BELAH"" duren yaaaa.\nGak dungu,ya gak cebong.\xf0\x9f\x98\x80\xf0\x9f\x98\x86\nMaaf ya.',1,1,1,0,0,0,0,0,1,1,0,0;;;;;;;;;;;;"	['belah duren ya dungu ya cebong xf0 x9f x98 x80 xf0 x9f x98 x86 maaf ya 1 1 1 0 0 0 0 0 1 1 0 0']	negative
Bubarkan HTI &amp; FPI. URL	['bubar hati amp front bela islam uniform resource locator']	negative
Ahok memang verbalnya keras. Pelampiasan dan pelarian karena kelelakiannya lunak.	['ahok verbal keras lampias lari lelaki lunak']	negative
USER Sekedar share juga temen2 kantor aku kalo ada pelanggan yg bercadar langsung bilang awas ada bom.. Aku hanya menghela nafas.. \xf0\x9f\x98\xaf'	['bagi teman teman kantor langgan cadar langsung bilang awas bom hela nafas xf0 x9f x98 xaf']	neutral
RT USER: Pantat mn nh pngen nusuk dan ditusuk\n\xf0\x9f\x91\x89Open BO WA 08157686707\n #gaybrondong #massageboy #gayjakarta #gayjogja #gaytangger\xe2\x80\xa6'	['pantat nih tusuk tusuk xf0 x9f x91 x89open bo wa 08157686707 gay berondong massage boy gayjaka a gay yogyakarta gay tangger xe2 x80 xa6']	negative
USER kayak orang nyosor mau minta nete ):'	['kayak orang nyosor nete']	negative
USER Ngewe bae'	['ngewe']	negative
USER Jebur bloon bukan cebur'	['jebur cebur']	negative
pak USER perlu melanjutkan rencana USER untuk menyeret USER ke pengadilan HAM PBB ! URL	['lanjut rencana seret adil ham pbb uniform resource locator']	neutral
Kisah hidup Muhammad yang lebih lengkap dapat didownload di sini	['kisah hidup muhammad lengkap unduh']	negative
USER USER USER USER USER USER we ada pipis onta tercecer di mari pantes bau pesing'	['we pipis onta cecer mari bau pesing']	negative
"USER USER Kalo kejadian disini, mungkin juga kalian yg triak paling lantang ""pmrth pro aseng"" duluan pas ditawari bantuan asing. Bikin posko ini itu yg intinya malah ngomporin keluarga korban sue pmrth. Bilang 15 hari kelamaan, harusnya 3,0,0,0,0,0,0,0,0,0,0,0,0;;;;;;;;;;;;"	['jadi teriak lantang pm h pro asing pas tawar bantu asing bikin posko inti kompor keluarga korban pm h bilang 15 3 0 0 0 0 0 0 0 0 0 0 0 0']	negative
RT USER: USER USER USER USER USER USER kaya monyet'	['kayak monyet']	negative
Survei di Metro TV Jokowi menang dari Presiden Baru; Etapi cara ngitungnya gimana ya 45% bisa ngalahin 46%; Jangan2 salah judul maksudnya Jokowi Masih Menangis; ; Sumber : Zie Bajrie	['survei metro televisi jokowi menang presiden hitung ya 45 kalah 46 salah judul maksud jokowi menang sumber zie bajrie']	negative
USER USER USER USER USER USER USER USER USER USER USER USER USER USER USER USER USER USER USER USER USER USER USER	['']	negative
Serunya Pesta Budaya Erau di Kutai Kartanegara!	['seru pesta budaya derau kuta kakak anegara']	negative
RT USER: ad yang mau contactnya? Retweet sekarang ya.....\nBanyak banget kenalan tante jilboob sange..\nIni Namanya Tante dea... O\xe2\x80\xa6'	['kontak retweet ya banget kenal tante jilboobs sange nini nama tante dea o xe2 x80 xa6']	positive
Duduki Istana Negara !! Sekalian Lengserkan Jokowi Salam2Tahun USER	['duduk istana negara lengser jokowi salam']	negative
RT USER Wah hebatnya pak USER.... Yg lg sibuk pencitraan... USER.. USER.. USER ..USER.... BACA NIH	['hebat sibuk citra baca nih']	negative
RT USER baby kafir budha teroris myanmar	['baby kafir buddha teroris myanmar']	negative
Indonesia Blom Merdeka Indonesia Masih Dijajah Oleh Orang Cina !!! TakbirAllauakbar URL	['indonesia merdeka indonesia jajah orang cina takbir allahu akbar uniform resource locator']	negative
"memang benar kata pengamat politik Hantayudha ...kalau paslon no.2 ini tidak ada "" khanZ"" nya di Jateng .; ; #JatengGayeng ; #2019TetapJokowi,0,0,0,0,0,0,0,0,0,0,0,0;;;;;;;;;;;;"	['amat politik hanta yudha pasang calon no 2 nya jawa jawa gayeng 2019 jokowi 0 0 0 0 0 0 0 0 0 0 0 0']	negative
RT USER USER jongos penista agama ahok sok sok ngong SARA.majikan nya penebar SARA astagfirllah. Tobat	['jongos nista agama ahok sok sok ngong sara majikan nya tebar sara astagfirullah tobat']	negative
USER USER USER USER Boleh saya follow bli juga? Saya katolik dan ikut akun prof USER utk menambah wawasan berbangsa...terima kasih'	['follow beli katolik akun prof tambah wawas bangsa terima kasih']	neutral
USER Kapan tuh si BEJAT CABUL USER balik ? Pengecut si Onta itu ye...'	['sih bejat cabul kecut sih onta iya']	negative
RT USER: USER USER adian gaya lu kaya beruk. Gini klo supir tembak metromini masuk dpr.\nKampungan lu.'	['adi gaya kayak beruk supir tembak metromini masuk dewan wakil rakyat kampung']	negative
"USER USER.. Km terlalu mainstream mengaartikan ""pintar"". Pintar itu relatif tergantung mo dibawa kemana pengertiannya. Spt anda pintar meng-undeeestimate-kan org. Gw pinter komen ajah. Rejim now pinter mangkrakin janji2 doang. So...making,1,0,1,0,0,0,0,0,1,1,0,0;;;;;;;;;;;;"	['km mainstream mengaa ikan pintar pintar relatif gantung bawa mana penge iannya surat pemberitahuan tahun pintar meng undeeestimate orang gue pintar komen rejim now pintar mangkrakan janji janji doang sok making 1 0 1 0 0 0 0 0 1 1 0 0']	negative
USER Kan emang gw dongo'	['gue dongok']	negative
USER USER ih masak di samain smaa sampah \xf0\x9f\x98\xa3\xf0\x9f\x98\xa3\xf0\x9f\x98\xa3'	['ih masak sama sampah xf0 x9f x98 xa3 xf0 x9f x98 xa3 xf0 x9f x98 xa3']	negative
USER USER USER USER Gw terpukaukaukau #2019GantiPresiden	['gue pukau 2019 ganti presiden']	negative
"Aspirasi Ibu Lina dari Sumedang kepada Calon Gubernur Jabar: ""Berantas Pelakor yang sdh meresahkan kehidupan warga desa"". :),0,0,0,0,0,0,0,0,0,0,0,0;;;;;;;;;;;;"	['aspirasi lina sumedang calon gubernur jabar berantas rebut laki orang resah hidup warga desa 0 0 0 0 0 0 0 0 0 0 0 0']	negative
USER Tu yang saya katakan sejak dulu lagi kita tak takut dgn cina atau parti Dap tapi kita bimbang fahaman yang dibawa oleh mereka....'	['takut cina i dap bimbang paham bawa']	negative
"""Cermin pun pecah saat dirinya berkaca""; ;,0,0,0,0,0,0,0,0,0,0,0,0;;;;;;;;;;;;"	['cermin pecah kaca 0 0 0 0 0 0 0 0 0 0 0 0']	negative
Awwww comel nya asing kan ikut warna'	['awwww comel nya asing warna']	positive
USER KRISTUS ANJING ASU JIAMPUT KEPARAT PICEK TELEK PEJUH SIWUK KOTANG SIWUK IDIOT KEPARAT PICEK TELEK PEJUH SIWUK KOTANG SIWUK IDIOT KEPARAT PICEK TELEK PEJUH SIWUK KOTANG SIWUK IDIOT KEPARAT PICEK TELEK PEJUH SIWUK KOTANG SIWUK IDIOT KEPARAT PICEK TELEK PEJUH SIWUK K	['kristus anjing anjing jembut keparat picek tai pejuh siwuk kutang siwuk idiot keparat picek tai pejuh siwuk kutang siwuk idiot keparat picek tai pejuh siwuk kutang siwuk idiot keparat picek tai pejuh siwuk kutang siwuk idiot keparat picek tai pejuh siwuk k']	negative
USER USER Ahhh itu kan perasaanmu saja utk menghibur diri.. mana ada cebong tdk bahagia.. presiden cebong punya... tol cebong punya... lha elo? Punya cuma germo \xf0\x9f\x98\x82\xf0\x9f\x98\x82\xf0\x9f\x98\x82'	['ah asa hibur cebong bahagia presiden cebong tol cebong germo xf0 x9f x98 x82 xf0 x9f x98 x82 xf0 x9f x98 x82']	negative
Agama: Kristen\nGolongan Darah: B\nAsal : San Fernando Valley'	['agama kristen golong darah b nasal san fernando valley']	negative
Budha bunuh muslim di myanmar	['buddha bunuh muslim myanmar']	negative
USER jahudi bangke minta sama jerman sana tempat ibadah'	['yahudi bangkai jerman ibadah']	negative
PapaMintaKetuaFraksi rakyat mau nya setya novanto keluar dari dpr bukan di pecat dari ketua dpr percuma saya di pecat dan masih ada di dpr	['papa ketua fraksi rakyat nya setya novanto dewan wakil rakyat pecat ketua dewan wakil rakyat pecat dewan wakil rakyat']	negative
USER USER USER USER Cina'	['cina']	negative
USER Hoax...; Kodok...; Biawak....; meroket...; sekop...; Bangsat...; Karbitan...; Munafik...; ; #2019GantiPresiden; #2019PresidenBaru; ; #2019TenggelamkanJokowiKesungaiSiak	['hoaks kodok biawak roket sekop bangsat karbitan munafik 2019 ganti presiden 2019 presiden 2019 tenggelam jokowi sungai siak']	negative
Itu yg pada ribut komunis blabla mungkin emoh baca. Yg baca pun kalo punya niat agitasi nyerang pemerintah pake ini cari simpatisan	['ribut komunis bla bla emoh baca baca niat agitasi serang perintah pakai cari simpatisan']	negative
10.Presiden Jokowi berharap skema kerja sama ini juga dapat dilakukan di dalam pembangunan-pembangunan lainnya.â?¦â?¦â?¦	['10 presiden jokowi harap skema kerja bangun bangun']	negative
pemilu langsung biar bwt milih presiden n dpr sj; capres pun biar tdk kyk kucing dlm karung, ; mgkn bisa bikin mekanisme baru yg lebih ok,; misal capres ditentukan dari gubernur yg berprestasi, jd yg boleh maju jd capres hanya yg sdh jd gubernur,,0,0,0,0,0,0,0,0,0,0,0,0;;;;;;;;;;;;	['pilih langsung biar pilih presiden dewan wakil rakyat calon presiden biar kayak kucing karung bikin mekanisme oke calon presiden tentu gubernur prestasi maju calon presiden gubernur 0 0 0 0 0 0 0 0 0 0 0 0']	negative
USER Namanya jg agama munafik...'	['nama agama munafik']	negative
43. Contoh lain: meski banyak tudingan dugaan korupsi tapi SBY tdk pernah dorong kejaksaan usut. Apalagi himbau KPK usut dugaan korupsi Jokowi	['43 contoh tuding duga korupsi susilo bambang yudhoyono dorong jaksa usut himbau komisi berantas korupsi usut duga korupsi jokowi']	negative
Saya mencium bau bau pecun URL	['cium bau bau pecun uniform resource locator']	negative
Pemburu Nazi Simon Wiesenthal memegang foto-foto yang menggambarkan mantan kepala Gestapo Walter Rauff dan sebuah van kamar gas bergerak yang dibuatnya untuk mengeksekusi orang-orang Yahudi.'	['buru nazi simon wiesenthal pegang foto foto gambar mantan kepala gestapo laki laki rauf van kamar gas gerak eksekusi orang orang yahudi']	negative
USER Bubarin nkri harga mati	['bubar negara satu republik indonesia harga mati']	negative
"USER Ingat baik-baik kata si royson, ""jokowi kacung gua..!""\n\nItulah mungkin alasan fundamentalnya kenapa rezim ini justru seperti sengaja masuk ke dalam ""Debt Trap"" KOMUNIS CINA!\n\nSo, menjadi wajib untuk #2019GantiPresiden!',1,1,1,0,0,1,0,0,0,1,0,0;;;;;;;;;;;;"	['sih royson jokowi kacung gue alas fundamental rezim sepe i sengaja masuk debt trap komunis cina north sumatera offshore wajib 2019 ganti presiden 1 1 1 0 0 1 0 0 0 1 0 0']	negative
USER USER WKWKWKWK MAMPUS. aku mau pepet ujin ah'	['wkwk mampus pepet uji ah']	negative
Gubernur jaman now ya anti hoax bukan nyebar isu yang tidak pasti #GanjarYasinMenang #GanjarYasin1 #KamiGanjarYasin	['gubernur jaman now ya anti hoaks sebar isu ganjar yasin menang ganjar yasin 1 ganjar yasin']	neutral
Azan di TV manggil2 Allah SWT dungu & biadab harus dihentikan dan acara catut nama Tuhan tidak boleh dilanjutkan	['azan televisi panggil manggil allah subhanahu wa taala dungu biadab henti acara catut nama tuhan lanjut']	negative
USER USER USER USER Semua itu terdapat pada kelakuan bani CEBONG....'	['laku bani cebong']	negative
Aku dah la baju macam yahudi betopi siap. 4 bas tu geng semua jubah putih kopiah minyak atar bejanggut dahi belekuk bak ahli syurga siap. Ni betol2 out of place. Mohon ak tak direjam'	['baju yahudi top 4 bas geng jubah putih kopiah minyak atar janggut dahi belekok bak ahli syurga nih out of place mohon rajam']	negative
USER Gua ge akan marah. Cuma auto blacklist dari kehidupan gue.\n\nSampah apa gunanya kalo ga didaur ulang?'	['gue ge marah auto daftar hitam hidup gue sampah guna daur ulang']	negative
USER USER Anjir apa rasanyaa bekas silit mah'	['anjir bekas silit']	negative
USER USER Cebong makin kepanasan jadi makin ngawur. \xf0\x9f\x98\x95\xf0\x9f\x98\x95'	['cebong panas ngawur xf0 x9f x98 x95 xf0 x9f x98 x95']	negative
amin smoga kalian bertiga bisa jd menampilkan yang terbaik dan menyumbangan medali buat sumsel	['amin moga be iga tampil baik sumbang medali sumatra selatan']	neutral
USER USER USER USER USER USER USER USER USER USER USER USER USER USER USER USER USER USER USER USER	['']	negative
"#GubernurZamanNow #GusIpulPuti2 #GanjarYasin1 #DjarotSihar2 #HasanAnton2 #KosterAce1 #NurdinSudirman3 #KarolinGidot2 RT USER: ""Keanekaragaman budaya, suku, agama, itulah sesungguhnya kekayaan kita,â?? tutur Djarot di hadapan peserta Rakercabsuâ?¦,0,0,0,0,0,0,0,0,0,0,0,0;;;;;;;;;;;;"	['gubernur zaman now gus ipul puti 2 ganjar yasin 1 djarot sihar 2 hasan anton 2 koster ace 1 nurdin sudirman 3 karolin gidot 2 keanekaragaman budaya suku agama sungguh kaya djarot hadap pese a rakercabsu 0 0 0 0 0 0 0 0 0 0 0 0']	neutral
USER edan aq yang masi newbie menangis saja liatnya yampun kartu R w aja masi dikit bat'	['edan mula menang lihat ya ampun kakak r gue banget']	negative
Nah..klo PKI alias Partai Korupsi Indonesia perlu diganyang juga ga?	['partai komunis indonesia alias ai korupsi indonesia ganyang']	negative
dijual lagi gua kaya jablay'	['jual gue kayak jablay']	positive
USER Mata w pas kecil sipit tp skrg malah engga. Aneh pisan'	['mata gue pas sipit aneh banget']	negative
Ko ingt aku buat banci ke gigih nk kira URL	['banci gigih natural killer uniform resource locator']	negative
MEWASPADAI CINA KOMUNIS YANG ADA DI INDONESIA!	['waspada cina komunis indonesia']	negative
USER Banci kampungan HEEEE!!!'	['banci kampung heeee']	positive
USER Gembel ganteng ga perlu dikasihani karena byk yg mencintainya. Asik asik jos'	['gembel ganteng kasihan cinta asyik asyik hebat']	positive
dekalarasi pilkada 2018 aman dan anti hoax Toga jemirahan jabon	['deklarasi pilih kepala daerah 2018 aman anti hoaks toga jemirahan jabon']	neutral
Setiausaha Agung Pas Datuk Takiyuddin Hassan sahkan ada pihak cuba pinda perlembagaan parti ini seperti yang dikatakan Presiden parti sebelum ini.	['setia usaha agung pas datuk takiyuddin hasan sahkan cuba pinda lembaga i sepe i presiden i']	neutral
USER USER EMANGNYA AKU NAJIS'	['memang najis']	negative
USER USER USER USER USER USER USER USER USER Sastra e karl mark. PENTOLAN komunis rusia.'	['sastra e karl mark pentol komunis rusia']	neutral
USER USER Ganti rezim kacung lah.. Cebong mah gitu kalo ditanya'	['ganti rezim kacung cebong']	negative
USER Kelamaan jomblo nanti jablay :('	['jomlo jablay']	negative
Perjaka kq di jual... \nSok sok an mau booking.. Tante idiot njir..'	['perjaka jual sok sok an booking tante idiot anjir']	negative
USER Rev 1: jgn pilih ulama yg DEKAT DG KAFIR dan MUNAFIK'	['rev 1 pilih ulama kafir munafik']	negative
Buat ngejaga kebersihan lingkungan tuh orang2 belum pada melek sama kewajibannya. Asal buang sampah dan ngomong = kan ada petugas kebersihannya'	['jaga bersih lingkung orang orang melek wajib buang sampah bicara tugas bersih']	negative
Segala permasalahan saat ini hanya ada satu solusi #2019GantiPresiden ; Jika pun tdk berdampak signifikan,sekurang?nya kita telah mengobati dan mencegah penyakit ini bertambah parah.,1,0,1,0,0,0,0,0,1,1,0,0;;;;;;;;;;;;	['masalah solusi 2019 ganti presiden dampak signifikan kurang nya obat cegah sakit be ambah parah 1 0 1 0 0 0 0 0 1 1 0 0']	negative
"USER Gampang kak, u buka hp, buka browser, ketik ""budaya palembang""; ; Silahkan menikmati pembelajaran denngan gratis:))),0,0,0,0,0,0,0,0,0,0,0,0;;;;;;;;;;;;"	['gampang kak buka handphone buka browser ketik budaya palembang sila nikmat ajar gratis 0 0 0 0 0 0 0 0 0 0 0 0']	negative
USER USER Segerombolan onta yg ngaku membela umat tapi itu semata2 demi kepentinga politik praktis.TGB jauh lebih demokratis dia mementingkan umat yg berpikiran modern.salut untukmu TGB'	['gerombol onta aku bela umat mata penting politik praktis tuan guru bajang demokratis penting umat pikir modern salut untuk tuan guru bajang']	negative
USER Culun mending kampung jes'	['culun mending kampung jess']	negative
RT USER: Goyangan jilboob mantap bener nih hyper kontol doi. \n\nTadi sambil squirt loh... \xf0\x9f\x98\x8d\xf0\x9f\x98\x8d\xf0\x9f\x98\x8d\n\nYang belum nonton live nya.. Besok doi\xe2\x80\xa6'	['goyang jilboobs mantap nih hyper kontol squi xf0 x9f x98 x8d xf0 x9f x98 x8d xf0 x9f x98 x8d tonton live nya besok xe2 x80 xa6']	positive
Presiden Aspek Indonesia Mbak USER :; Kami tidak Anti Investasi Asing; Tapi , apabila berubah jadi Invasi Asing, sudah kewajiban KITA sebagai Warga Negara utk melawannya,0,0,0,0,0,0,0,0,0,0,0,0;;;;;;;;;;;;	['presiden aspek indonesia mbak anti investasi asing ubah invasi asing wajib warga negara lawan 0 0 0 0 0 0 0 0 0 0 0 0']	negative
â?¶Pkl 09.15 wib ; Kanit Binmas Ipda Mt. Hutasoit melaks Sambang dan menyampaikan pesan2 kamtibmas ttg pilgub dan pilkada 2018 kpd Karyawan BRI Ranting Muara DAMENRA SIHITE dkk di Desa Hutanagodang Kec. Muara Kab. Tap. Utara.	['09 15 indonesia barat kepala unit bina masyarakat inspektur polisi mt hutasoit laksana sambang pesan pesan aman tertib masyarakat pilih gubernur pilih kepala daerah 2018 karyawan bank rakyat indonesia ranting muara damenra silit kawan kawan desa hutanagodang camat muara kabupaten tap utara']	negative
â??fardu kifayahâ?? atau berhukum wajib dalam ajaran Islam. Pada pilpres mendatang, harus ada utusan dari kalangan santri yang disokong ulama untuk maju memimpin negeri.;,0,0,0,0,0,0,0,0,0,0,0,0;;;;;;;;;;;;	['fardu kifayah hukum wajib ajar islam pilih presiden utus kalang santri sokong ulama maju pimpin negeri 0 0 0 0 0 0 0 0 0 0 0 0']	negative
USER Hah? Wah bangke emang nih truk'	['ha bangkai nih truk']	negative
Nahdliyin Minta Setop Penghinaan Terhadap Maruf Amin	['nahdliyin setop hina maruf amin']	negative
USER Risa baru saja pulang dari pelatihan khususnya ketika iris hazel miliknya menangkap siluet seorang gadis. Gadis yang sangat asing.\n\nBelum pernah Risa temui gadis ini sebelumnya di radio tempatnya tinggal dan bekerja ini. Maka dari itu R	['risa pulang latih iris hazel milik tangkap siluet gadis gadis asing risa temu gadis radio tempat tinggal r']	neutral
USER USER USER Hahahaha orang gila ngomong cak..??\nMakanya jangan terlalu banyak micin biar otak loe encer cong...\nNgomong ae ngawur muslim kamu itu muslim silit tau...babi.'	['haha orang gila bicara cak micin biar otak encer cong omong ngawur muslim muslim silit tau babi']	negative
muhammadiyahinggris jalin kerjasama pengendalian ekstrimisme	['muhammadiyah inggris jalin kerja kendali ekstrem']	positive
"BOT mau nanya. 'ich liebe dich' artinya apa? Yg jawab ntar BOT kasih aipet yg barusan nyemplung di jamban kuda (\xe2\x80\xa2\xcc\xaf\xcd\xa1_\xe2\x80\xa2\xcc\xaf\xcd\xa1 )"",0,1,0,0,0,0,0,0,0,0,0,0;;;;;;;;;;;;"	['bot ih liebe ih a inya bot kasih ipad barusan cemplung jamban kuda xe2 x80 xa2 xcc xaf xcd xa1 xe2 x80 xa2 xcc xaf xcd xa1 0 1 0 0 0 0 0 0 0 0 0 0']	negative
COPOT Darmin Nasution Menko Perekonomian BODOH yang turunkan daya beli sejak menjabat USER USER	['copot darmin nasution menteri ekonomi ekonomi bodoh turun daya beli jabat']	negative
RT USER: Bodo amat anjir bodo ngakak gua ngakak astagfirullah humor bet URL	['bodoh anjir bodoh tertawa gue tertawa astagfirullah humor banget uniform resource locator']	negative
USER Coba dedengkot JIN terus terang ke para ulama Saudi atau rilis ke publik tentang akidah JIN. Contoh, JIN tidak anggap kafir pemeluk Kristen, Hindu, Budha, dll; semua punya peluang masuk surga. \nAku yakin akan keluar fatwa dari Saudi: JIN adal,0,0,0,0,0,0,0,0,0,0,0,0;;;;;;;;;;;;	['coba dedengkot jin terang ulama saudi rilis publik akidah jin contoh jin anggap kafir peluk kristen hindu buddha peluang masuk surga fatwa saudi jin adal 0 0 0 0 0 0 0 0 0 0 0 0']	negative
USER Atau seperti hujan lebat dari langit, bersama dengan gelap-gelita, dan guruh serta kilat; mereka menyumbat jarinya ke dalam telinga masing-masing dari mendengar suara petir, kerana mereka takut mati. (Masakan mereka boleh terlepas) sedang Allah me,0,0,0,0,0,0,0,0,0,0,0,0;;;;;;;;;;;;	['sepe i hujan lebat langit gelap gelita guruh a kilat sumbat jari telinga dengar suara petir ranah takut mati masakan lepas allah me 0 0 0 0 0 0 0 0 0 0 0 0']	negative
Cerdas dan konseptual	['cerdas konseptual']	positive
"USER ""Namaku Baek Yoon\xe2\x80\x94gi ...""\n\nUcapan terputus seiring dia mengerjap mata yang terasa mengantuk sedikit demi sedikit. Gigit bibirnya ragu karena dia ingin menggapai gelas sekali lagi untuk meminum sebagaimana wine yang ditinggal di m,0,0,0,0,0,0,0,0,0,0,0,0;;;;;;;;;;;;"	['nama yoon xe2 x80 x94gi ucap putus iring sergap mata antuk gigit bibir ragu gapai gelas minum wine tinggal 0 0 0 0 0 0 0 0 0 0 0 0']	negative
"// Aduh lucu banget adek kelas gue pas SMA laporan katanya ""bang hari ini kita field trip ke Taman Safari, heran dah (nyebut 1 nama temennya dia) mau arisan ama keluarganya aja bawa 1 sekolahan.""\n\nTai, arisan.',0,1,0,0,0,0,0,0,0,0,0,0;;;;;;;;;;;;"	['aduh lucu banget adik kelas gue pas lapor bang field trip taman safari heran sebut 1 nama teman arisan keluarga bawa 1 sekolah tai arisan 0 1 0 0 0 0 0 0 0 0 0 0']	negative
USER Gimana mainnya asw'	['main anjing']	negative
Warga Semarang Prihatin Kontroversi Puisi Gus Mus	['warga semarang prihatin kontroversi puisi gus mus']	neutral
Celeng nya bang acon susah bgt dah \xf0\x9f\x98\xa	['celeng nya bang acon susah banget xf0 x9f x98 xa']	negative
USER tapi kenapa kamu malah cari musuh! dasar peranakan cebong kampret!'	['cari musuh dasar ana cebong kampret']	negative
USER USER USER Yang juara ngibul kan junjungan kalian wahai bani kampret 212'	['juara tipu junjung bani kampret 212']	negative
USER Aku ga ada keturunan cina tapi aku sipit?'	['turun cina sipit']	negative
USER Tanya amin rais.. Dulu dia yg bikin kacau dan nyuruh reformasi. Pilkada salah satu hasilnya.	['amin rais bikin kacau suruh reformasi pilih kepala daerah salah hasil']	negative
Fahri Hamzah: Kalau Saya Jadi Presiden KPK Akan Saya Bubarkan URL	['fahri hamzah presiden komisi berantas korupsi bubar uniform resource locator']	negative
Dia takut banci tapi :( USER URL	['takut banci uniform resource locator']	negative
LINMAS WILAYAH TAWANGSARI, BULU &amp; WERU TERIMA PEMBEKALAN PAM PILKADA SERENTAK,0,0,0,0,0,0,0,0,0,0,0,0;;;;;;;;;;;;	['lindung masyarakat wilayah tawangsari bulu amp lihat terima bekal pam pilih kepala daerah serentak 0 0 0 0 0 0 0 0 0 0 0 0']	neutral
USER KENAPA BOLOT'	['bolot']	negative
Doi tuh native speaker ya.\n\nMother language-nya english.\n\nKomen dijaga dong bangsad'	['native speaker ya mother language nya english komen jaga bangsat']	negative
Kita-kita biasa aja dengan pernyataan yang ada. Ga ngerasa bangke.'	['nyata bangkai']	negative
"Uname absurd bahkan first impression gak akan bikin enak imaginenya, dan gak ganteng typing pas dicoba eue di dm enak banget. Berharap di dm lagi ternyata enggak sama sekali:"")',0,0,0,0,0,0,0,0,0,0,0,0;;;;;;;;;;;;"	['nama guna absurd first impression bikin enak imajinasi ganteng etik pas coba ngewe direct message enak banget harap direct message 0 0 0 0 0 0 0 0 0 0 0 0']	negative
USER USER Admin.. Bukan presiden.. Tapi pm	['admin presiden pm']	neutral
RT USER: Stw singaraja suka kontol URL	['stw singaraja suka kontol uniform resource locator']	negative
USER USER USER kafir haram jadi pemimpin nyet'	['kafir haram pimpin monyet']	negative
Shio baekhyun itu Monyet'	['shio baekhyun monyet']	positive
USER Pernah ngelakuin dosa apa ya anis dan sandi sampe di bully dan di rendahkan terus2an. Padahal masih bnyk orng yg jahat dan licik yg sebenarny lebih pantas di bully dan rendahkan. Dunia memang kejam kawan. \xf0\x9f\x98\xa7'	['dosa ya anis sandi bully rendah terus orang jahat licik bully rendah dunia kejam kawan xf0 x9f x98 xa7']	negative
USER om kalo memang om belajar agama budha atau hindu yg bener seharusnya ga bgini. Coba belajar yg bener ya sebelum buka mulut	['om om ajar agama buddha hindu coba ajar ya buka mulut']	negative
USER Ikut pengalaman yg tak seberapa kerja part time dengan cina lebih best dari kerja dengan melayu. Haha.'	['alam kerja time cina best kerja melayu haha']	negative
USER aku gakuat karna jijik makanya ku cepetin \xf0\x9f\x98\x8c berasa kita yg dikejar2 yaaa sampe mau napas aja jadi sungkan wkwkwk'	['kuat jijik ku cepat xf0 x9f x98 x8c asa kejar kejar ya napas sungkan wkwk']	negative
RT USER Bubarkan DPR BUBARKAN.. SAVEKPK	['bubar dewan wakil rakyat bubar save komisi berantas korupsi']	negative
Gua daiping mampus lu junedi'	['gue diving mampus junedi']	negative
RT USER: Suciwati: Revolusi Mental Jokowi Omong Kosong/Bualan. Jika Setuju RT &amp; Comment URL	['suciwati revolusi mental jokowi omong kosong bual tuju amp komen uniform resource locator']	neutral
"Saya juga pernah marahin seorang rp yang panggil saya sipit waktu jadi Hoshi. Atau yang suka tanya ""matanya mana?""\nSepele? Tidak ah. Itu kan bagian dari fisik.\nMungkin kalau dipakai untuk definisi, macam: Hoshi itu yang memiliki mata sipit; boleh deh.,0,0,0,0,0,0,0,0,0,0,0,0;;;;;;;;;;;;"	['marah rupiah panggil sipit hoshi suka mata sepele ah fisik pakai definisi hoshi milik mata sipit deh 0 0 0 0 0 0 0 0 0 0 0 0']	negative
USER Jangan jangan otak makelar penjual asset negara apa maling asset negara ? \xf0\x9f\x91\x89USER pertamina di jual mau di isi TKA dari Tiongkok \xe2\x9d\x93#2019GantiPresiden \nURL	['otak makelar jual aset negara maling aset negara xf0 x9f x91 x89 pe amina jual isi tenaga kerja asing tiongkok xe2 x9d x93 2019 ganti presiden nurl']	negative
USER Akun Siti Fatimah &amp; yg komen di lamannya, diringkes semua aja...parah &amp; bejat. Memalukan...!!! Bp USER ...semoga sehat selalu, tetap sabar , &amp; semangat terus suarakan kebenaran....',1,1,1,0,0,0,0,0,1,1,0,0;;;;;;;;;;;;	['akun siti fatimah amp komen laman ringkas parah amp bejat malu moga sehat sabar amp semangat suara benar 1 1 1 0 0 0 0 0 1 1 0 0']	negative
USER USER USER Bawang putih itu sdg kafir haram lagi..\nHiks.hiks..hiks'	['bawang putih kafir haram his hiks hiks']	negative
Setuju ahokers lengserkan ke prabon jokowi daripada ancurin penjara ga karuan.. URL	['tuju ahoker lengser prabowo jokowi hancur penjara karuan uniform resource locator']	negative
RELAWAN JOIN ADALAH SEBUAH GERAKAN ARUS BAWAH yg MERINDUKAN KEPEMIMPINAN NASIONAL DARI NASIONALIS + ISLAM MODERAT..; ; #CakIminTheNextWapres ; #JOIN2019 ; ; USER USER USER USER USER USER USER USER	['rawan join gera arus rindu pimpin nasional nasionalis islam moderat cak imin the next wakil presiden join 2019']	neutral
USER onta tu nsd??'	['onta nsd']	negative
USER Umpannya pake apaan tu biar mancing dpt buaya?'	['umpan pakai biar mancing buaya']	positive
USER USER USER USER USER USER USER USER USER USER USER USER USER Komunis kok berabtad PKI? Kecoak makan kecoak dong?'	['komunis abad partai komunis indonesia kecoak makan kecoak']	negative
Retweeted ikko pribumi kawe (USER):; ; Horas Horas Horas !!; ; Dengan menggunakan kapal feri Presiden mengunjungi pulau samosir dlm rangkaian kunjungan kerja ; ; Presiden di sambut dgn upacara adat samosir dg pekikan Horas Horas Horas ; ; USER	['retweeted ikko pribumi tiru horas horas horas kapal feri presiden unjung pulau samosir rangkai kunjung kerja presiden sambut upacara adat samosir pekik horas horas horas']	neutral
USER as clara\n- anak pinter\n- dongo\n- paling koplak\n- cantik tapi idot :(\n- gatau malu \n- urat malu putus\n- butt dia muka nya imut bgt'	['as clara anak pintar dongok kocak cantik idot tau malu urat malu putus butt muka nya imut banget']	negative
"Menag USER minta riset PTKIN jgn hanya berorientasi publikasi artikel di Scopus dan sejenisnya. Namun, outputnya hrs bisa jawab tantangan umat Islam"". PTKIN perlu buat pangkalan data sbg rujukan pembangunan. Misal database ulama Nusantara shg g,0,0,0,0,0,0,0,0,0,0,0,0;;;;;;;;;;;;"	['menteri agama riset guru agama islam negeri orientasi publikasi a ikel scopus jenis keluar tantang umat islam guru agama islam negeri pangkal data rujuk bangun database ulama nusantara 0 0 0 0 0 0 0 0 0 0 0 0']	negative
Presiden paling buruk dalam sejarah bangsa2 cebong'	['presiden buruk sejarah bangsa bangsa cebong']	negative
Me nusantara kan dlm arti nasionalisasi assets yg dikuasai asing hny bisa dilakukan pemimpin yg sungguh nasionalis patriotis.\n\nNusantara versi proxy hny bertujuan lemahkan ketahanan nusantara/nasional suatu bangsa'	['me nusantara a i nasionalisasi aset asai asing pimpin sungguh nasionalis patriotik nusantara versi proxy be uju lemah tahan nusantara nasional bangsa']	negative
USER Remukan rengginang cocot ah'	['remuk rengginang cocot ah']	positive
USER USER USER USER USER USER USER USER USER USER USER USER USER USER USER USER USER USER USER USER USER USER USER USER USER USER USER	['']	negative
USER Sudah diadopsi pemerintah pusat juga nich. ; ð??»;	['adopsi perintah pusat nih']	negative
USER USER ..... Pak Prof. ..... Jangan pak Prof. Bilang itu cuma soal pendapat.... Itu tdk benar karena disampaikan di forum terbuka.... Itu ngaco dan tdk bisa di biarkan.... Pak Prof. Sebagai pemuka agama dan sebagai Ulama harusnya melur	['prof prof bilang dapat forum buka kacau biar prof muka agama ulama melur']	negative
USER USER Biadab tuh oknum aparat keparat'	['biadab oknum aparat keparat']	negative
USER Hahahaha jancuk'	['haha jancuk']	negative
USER Untung aku kunti.g'	['untung kunti']	positive
Wuakkakaa.. mampuss!! ga salah gue diblock dia sejak jaman Jokowi Ahok nyagub. Gaya lo toong.. toong.. Anies sandi URL	['wkwk mampus salah gue blok jaman jokowi ahok calon gubernur gaya intip intip anies sandi uniform resource locator']	negative
Dan dari orang asing yang ngobrol karena bosen nunggu transit akhirnya jadi temenan sampe sekarang :)'	['orang asing obrol bosan tunggu transit teman']	negative
USER USER USER USER Itu dia mata picek... Matanya cuma lihat sebelah...'	['mata picek mata lihat belah']	neutral
USER USER Maaf sebenarnya twiter pertama kali dbuat bukan buat orang bego'	['maaf twitter pe kali orang bego']	negative
USER Ha ha kocak ...kalabong emang dungu'	['kocak kalabong dungu']	negative
Mengenal Walpri Perempuan dalam Pilkada Bondowoso â?? Radar Jember	['kenal awal pribadi perempuan pilih kepala daerah bondowoso radar jember']	neutral
USER USER USER Disana mayoritas Budha. Ada jg pendetanya yg ikut Demo. Kau googling lah video demo di Thailand biar tau.'	['mayoritas buddha pendeta demo googling video demo thailand biar tau']	negative
USER USER Begitulah cara komunis bermain.'	['komunis main']	negative
suka kesel sama orang yang pas gua jadian confess ke gua giliran gua jomlo malah pada kemana tau NGOMONG SAMA SILIT'	['suka kesal orang pas gue jadi confess gue gilir gue jomlo mana tau bicara silit']	positive
"Kita balas di sini gima kita usir budha ""USER: Kurang Ajar, Etnis Muslim Rohingya Disingkirkan dari Data Sensus Penduduk Myanmar,1,0,0,1,1,0,0,0,0,0,0,1;;;;;;;;;;;;"	['balas usir buddha ajar etnis muslim rohingya singkir data sensus duduk myanmar 1 0 0 1 1 0 0 0 0 0 0 1']	negative
Astagfirullah mata gw ternodai \nTerkutuk kau yg ngert bokep \xf0\x9f\x98\xad[]'	['astagfirullah mata gue noda kutuk nge bokep xf0 x9f x98 xad']	negative
allah tidak memanggil orang yang mamputetapi allah akan memampukan siapa saja yang mauyang rinduyang yakin ke baitullah	['allah panggil orang allah mampu rindu baitullah']	positive
PENGOBATAN MONYET KEDIH URL	['obat monyet kedih uniform resource locator']	negative
USER pergi lo bangkai'	['pergi bangkai']	negative
Kebingungan akan apa yang bisa ditoleransi dan enggak bikin Gw mikir itulah alasan kenapa dalam Katolik ada Paus sebagai Wakil Kristus'	['bingung toleransi bikin gue pikir alas katolik paus wakil kristus']	positive
USER || Itu... udah... ketawa kunti...'	['tertawa kunti']	negative
Aamiin ya rabb.. Tolong USER Indonesia ya Alah dgn yg lebiiihhhh baik..	['amin ya rabi tolong indonesia ya alah lebiiihhhh']	neutral
RT USER: Ustadz PKS Yudi Widiana nilep duit pk bahasa agama Juz &amp; Liqo Felix Kwetiauw &amp; alumni 212 pd mingkem &amp; pura2 budek..giliran Bu\xe2\x80\xa6'	['ustaz partai adil sejahtera yudi widiana tilap duit bahasa agama juz amp liqo felix kwetiau amp alumni 212 diam amp pura pura budek gilir bu xe2 x80 xa6']	negative
USER Amin... Smoga Istiqomah...\nJgn khawatir cibiran org anggap aja ujian..\nIngat banyak org2 yg dulunya masalahnya suram bahkan kafir sekalipun kemudian taubat dan menjadi tokoh pejuang agama Islam...'	['amin moga istikamah khawatir cibir orang anggap uji orang orang dulunya suram kafir taubat tokoh juang agama islam']	negative
Video call dengan Pak Gubernur USER yang sedang dinas ke Istanbul, Turkey. Dalam video call ini saya melaporkan yang pertama ialah tempat hiburan malam Karaoke Sense &amp; Diskotik Exotic telah ditutup secara hormat tanpa harus keras, dibantu ole,0,0,0,0,0,0,0,0,0,0,0,0;;;;;;;;;;;;	['video call gubernur dinas istanbul turki video call lapor pe hibur malam karaoke sense amp diskotik eksotik tutup hormat keras bantu ole 0 0 0 0 0 0 0 0 0 0 0 0']	neutral
USER ITULAH si ahok kutil babi	['sih ahok kutil babi']	negative
USER kenapa Sukarno tidak di konotasikan juga rejim anti demokrasi\ndg embel2 presiden seumur hidup?'	['soekarno konotasi rejim anti demokrasi ndg embel embel presiden umur hidup']	negative
Hajar ndan.. ganyang PKI URL	['hajar ganyang partai komunis indonesia uniform resource locator']	negative
Bangke sampe kg bsa tidur siang :('	['bangkai kg tidur siang']	negative
Pak jokowi kasian jg goregan PBB	['jokowi kasihan goreng pbb']	negative
USER Amiinnnn; Dan Semoga Pak Jokowi jadi presiden lagi.	['amin moga jokowi presiden']	neutral
Kapolri USER harusnya mundur dari jabatannya...	['kepala polisi republik indonesia mundur jabat']	neutral
Berdayakan Ekonomi Pesantren Ulama Jawa Barat Dukung Jokowi di Pilpres 2019; #TetapJokowi2019	['daya ekonomi pesantren ulama jawa barat dukung jokowi pilih presiden 2019 jokowi 2019']	neutral
Semangat Terus Pak USER. ; Kantor Staf Presiden Harus Terdepan Publikasikan Semua Kegiatan Presiden Supaya Rakyat Tau Bahwa Presiden Kerja Keras Membangun Bangsa ini, kerja.. kerja.. kerja; USER USER; USER USER,0,0,0,0,0,0,0,0,0,0,0,0;;;;;;;;;;;;	['semangat kantor staf presiden depan publikasi giat presiden rakyat tau presiden kerja keras bangun bangsa kerja kerja kerja 0 0 0 0 0 0 0 0 0 0 0 0']	negative
USER DARIPADA COCOT'	['cocot']	negative
USER USER USER USER Kristen Nusantara pasti ada conth HKBP Huria Krsten Batak Protestan; GKJ Greja Kristen Jawa; Gereja Pasundan; Gereja Manado; Gereja Maluku; Gereja Papua; dll. Masing2 punya ciri khas sesuai tradisi suku masing	['kristen nusantara contoh huria kristen batak protestan huria kristen batak protestan gereja kristen jawa gereja kristen jawa gereja pasundan gereja manado gereja malu gereja papua ciri khas sesuai tradisi suku']	negative
RT USER USER USER Baru 3tahun dah segitu ya bentar lagi lewat utang sby njiiieng	['ya bentar utang susilo bambang yudhoyono njiiieng']	neutral
USER USER USER USER USER USER USER USER USER USER USER USER USER USER Freeport takkan berdiam saja setelah negisiasi kalah..	['freepo diam negosiasi kalah']	negative
Negara kayak menipu bocah SD aje.. Dokumennya hilang ... Fuih..	['negara kayak tipu bocah sekolah dasar dokumen hilang huh']	negative
Allah SWT yang disembah dungu & biadab ya PERCUMA	['allah subhanahu wa taala sembah dungu biadab ya']	negative
RT USER ogah prabowo+pak gatot baru ok	['ogah prabowo gatot oke']	neutral
Perbanyaklah membaca CERDAS biar gak dicap goblok :v\n\n#just_kidding\nNB : hanya orang dengan IQ diatas rata-rata yang mengerti tulisan di atas :v'	['banyak baca cerdas biar cap goblok v just kidding maaf balas orang intelligence quotient menge i tulis v']	negative
USER Burik. Iya yg gitu burik panuan kutuan jamuran. Hah emang rang ajar.'	['burik iya burik panuan kutu jamur ha rang ajar']	negative
USER We jancuk ngapain aku belajar'	['we jancuk ajar']	negative
Amin Rais himbau masyarakat jangan sampai salah memilih pemimpin.	['amin rais himbau masyarakat salah pilih pimpin']	negative
Jd cowo banyak bacot amat si ajg mau gua gampar aja rasanya []'	['cowok bacot sih anjing gue gampar']	negative
Rizal Ramli: Mayoritas Masyarakat Tak Mau Beri Kesempatan Kedua Untuk Jokowi #KlikRMOL #capresrakyat	['rizal ramli mayoritas masyarakat sempat jokowi klik rmol calon presiden rakyat']	neutral
#ILCBoedionoCentury ketika ini terjadi, saya ikuti kasus ini cukup intens. Meski sekarang agak lupa...; Tapi kuncinya kita cuma butuh 2019 Ganti Presiden! Itu...,1,0,1,0,0,0,0,0,1,1,0,0;;;;;;;;;;;;	['indonesia lawyers club boediono century ikut intens lupa kunci butuh 2019 ganti presiden 1 0 1 0 0 0 0 0 1 1 0 0']	neutral
Maju Gubernurnya Sengsara Relawannya	['maju gubernur sengsara rawan']	negative
"Mngkin sya bkan org baik,dan sya tidak perlu di anggap baik.paling tdk sya tdk munafik dgn berpura""baik.karena yg terpenting sya bisa berbuat baik',0,0,0,0,0,0,0,0,0,0,0,0;;;;;;;;;;;;"	['orang anggap munafik pura penting buat 0 0 0 0 0 0 0 0 0 0 0 0']	negative
RT USER: Copras calon presiden.. Ndak mikir.. Ndak mikirrrr... (Ndak mikir apa si kowi 1 periode aja babak belur..) URL	['copras calon presiden pikir mikirrrr pikir sih kowi 1 periode babak bur uniform resource locator']	neutral
Cie tau ma jokowi ga dapet panggung mulai dah jilat-jilat Prabowo dasar lintah URL	['tau jokowi panggung jilat jilat prabowo dasar lintah uniform resource locator']	negative
"Barusan dongo dongoin pemotor yg klakson bertubi2 padahal jelas lampu merah. ""Woy dongo! Brisik norak!"" \n\nPas nengok taunya temen SMP (--!)\n\nDia : Chaink?\n\n*aku nangis nganti metu eluh getih puteeeh~',1,1,1,0,0,0,0,0,1,1,0,0;;;;;;;;;;;;"	['barusan dongok dongok motor klakson be ubi2 lampu merah oi dongok berisik norak pas tengok tau teman chain menang ganti lu darah puteeeh 1 1 1 0 0 0 0 0 1 1 0 0']	negative
"""Presidennya Pak Jokowi, gubernurnya saya dan Pak Anton, sehingga program selaras sejalan,"" kata Hasan.,0,0,0,0,0,0,0,0,0,0,0,0;;;;;;;;;;;;"	['presiden jokowi gubernur anton program selaras jalan hasan 0 0 0 0 0 0 0 0 0 0 0 0']	negative
Kalau nggak mau dengar Ulama dan tetap ngotot kriminalisasi ulama yaa kita lengserkan aja Jokowi	['dengar ulama otot kriminalisasi ulama ya lengser jokowi']	negative
Cina lg.. cina lg.. sebaiknya di usir aj ya? merusak sih kerjaannya	['cina cina usir ya rusak sih kerja']	negative
USER Ayoh bangsa indonesia bersihkan etnis cina ahok	['ayo bangsa indonesia sih etnis cina ahok']	negative
USER enak bgt yah Om jawabannya.\n\ngmn klo udah bom sby jgn diperdebatkan lagi tersangkanya udah meninggal...'	['enak banget ya om jawab bom susilo bambang yudhoyono debat sangka tinggal']	neutral
USER USER USER USER USER Kafir ada di Alquran....situ sehat???'	['kafir alquran situ sehat']	negative
RT USER Nggak ikut dukung calon presiden tapi sukanya ngatur Jokowi kenapa gak Prabowo aja yg diatur supaya menang dalam pemilihan presiden 2019.	['dukung calon presiden suka atur jokowi prabowo atur menang pilih presiden 2019']	positive
USER Kan hebat Ahok bisa memaafkan bini slm 7 thn bukan spt yg ono kabur krn ketauan menalukan ngaku ulama kok kelakuan bejad'	['hebat ahok maaf bini salam 7 surat pemberitahuan tahun ono kabur tahu malu aku ulama laku bejat']	negative
"USER Okesip otak bolot gue konfyus :')"",0,1,0,0,0,0,0,0,0,0,0,0;;;;;;;;;;;;"	['oke sip otak bolot gue bingung 0 1 0 0 0 0 0 0 0 0 0 0']	negative
yg jelas-jelas masih hidup itu prabowo anak soemitro pengkhianat bangsa	['hidup prabowo anak soemitro penghianat bangsa']	neutral
USER USER Yang perek kan ibu lo.. gimana sih.. pasti sdh dool ya'	['perek sih doll ya']	positive
RT USER USER USER Pilih presiden yg jelas orang tua nya yang bukan pengkhianat negara	['pilih presiden orang tua nya penghianat negara']	negative
Ga apa sih Ahok prnh diblng penista agama tp ga kek politikus koruptor dipanggil urusan hukum ngeles pake sakit hati-hati ntar keterusan mati.	['sih ahok bilang nista agama kayak politikus koruptor panggil urus hukum ngeles pakai sakit hati hati terus mati']	negative
USER USER USER Tolol sekali anda ini? Ngaji dimana kau ini kl agama islam sprti itu? Ketahuan ini orang ngajinya sm orang ngk jelas ini?'	['tolol aji mana agama islam sp i tahu orang aji orang']	negative
New post: Festival Pesona Tambora Angkat Eksotisme Alam dan Budaya Dompu dan Bima	['new post festival pesona tambora angkat eksotisme alam budaya dompu bima']	neutral
Presiden Joko Widodo (Jokowi) membuka Kongres 29 Perhimpunan Mahasiswa Katolik Republik Indonesia (PMKRI).; ; USER berpesan di konteks tahun politik 2018, agar semua pihak menjaga kondisi. Kontestasi politik perlu diisi dengan adu program dan gagasan ra,0,0,0,0,0,0,0,0,0,0,0,0;;;;;;;;;;;;	['presiden joko widodo jokowi buka kongres 29 himpun mahasiswa katolik republik indonesia himpun mahasiswa katolik republik indonesia pesan konteks politik 2018 jaga kondisi kontestasi politik isi adu program gagas ra 0 0 0 0 0 0 0 0 0 0 0 0']	negative
"USER Cebong di kasih fakta dia bilang dusta, Cebong dikasih dusta dia bilang realita, Cebonger's emang bikin gemes\xf0\x9f\x98\x82"",1,1,0,1,0,0,0,0,1,0,1,0;;;;;;;;;;;;"	['cebong kasih fakta bilang dusta cebong kasih dusta bilang realita cebonger si bikin gemas xf0 x9f x98 x82 1 1 0 1 0 0 0 0 1 0 1 0']	negative
USER USER Cina kafir ini mah...Bangsat lu!! Dasar Komunis !!'	['cina kafir bangsat dasar komunis']	negative
USER USER USER Rakyat kaum bani cebong'	['rakyat kaum bani cebong']	negative
kangen edan USER USER'	['kangen edan']	positive
USER Ohh mami kontolku besar panjang 3jari setengah panjang lewat pusat aku..mungkin 3 aku ngentot mami.mami kecapaian...'	['oh mami kontol jari pusat 3 ngentot mami mami capai']	neutral
"Di kuliah umum Maroko, ada yg bilang Anies ""Super Gubernur"".; Mungkin jaga perasaan, gak enak klo bilang ""Anda yg lebih layak jadi Presiden"" :-),0,0,0,0,0,0,0,0,0,0,0,0;;;;;;;;;;;;"	['kuliah maroko bilang anies super gubernur jaga asa enak bilang layak presiden 0 0 0 0 0 0 0 0 0 0 0 0']	negative
Ga salah memang USER &amp; USER bilang antek Aseng tapi adiknya Prabowo bilang Prabowo pro Amerika. URL	['salah amp bilang antek asing adik prabowo bilang prabowo pro amerika uniform resource locator']	negative
"Dijodohkan Presiden, Pengantin Wanita Tajikistan Tampak ""Sedih"",0,0,0,0,0,0,0,0,0,0,0,0;;;;;;;;;;;;"	['jodoh presiden pengantin wanita tajikistan sedih 0 0 0 0 0 0 0 0 0 0 0 0']	negative
"7. Kaga ngeliat tapi ""ngerasa"" wkakak dan gua ngerasa lagi tot sma setan',0,1,0,0,0,0,0,0,0,0,0,0;;;;;;;;;;;;"	['7 wkwk gue tot setan 0 1 0 0 0 0 0 0 0 0 0 0']	negative
RT USER: Eh ada wartawan Selandia Baru Rasa Kampret dan dibuat berita oleh Kampret disebar di WAG. Konferensi Pers tdk dilakukan\xe2\x80\xa6'	['eh wa awan selandia kampret berita kampret sebar kasih konferensi pers xe2 x80 xa6']	negative
USER USER USER USER USER Pencitraan Lu...ah.......Prabowo msh tidur.....	['citra ah prabowo tidur']	negative
Ustadz Subki Al-Bughury, S. Sos.I saja mendukung Pilkada Damai di Kab. Sinjai Tanpa Hoax, Ujaran Kebencian dan Isu Sara,..KALAU ANDA...??; USER USER USER,0,0,0,0,0,0,0,0,0,0,0,0;;;;;;;;;;;;	['ustaz subki al bughury si sos i dukung pilih kepala daerah damai kabupaten sinjai hoaks ujar benci isu sara 0 0 0 0 0 0 0 0 0 0 0 0']	negative
RT USER: #RETWEET\nSensasi Ngentot Dengan Cewek Cantik Berhijab ...\xf0\x9f\x98\x8d\n\n( Part1)\n\n#blowjob #kontol #hijab #ngentothijab #sepongkon\xe2\x80\xa6'	['retweet sensasi ngentot cewek cantik hijab xf0 x9f x98 x8d 1 blowjob kontol hijab ngentot orang hijab sepong kontol xe2 x80 xa6']	negative
USER USER USER USER USER biasa bro dia ciri2 cebong adu domba begitu so lugu namanya juga cebong buzzer recehan yg begini\xf0\x9f\x98\x82\xf0\x9f\x98\x82\xf0\x9f\x98\x82'	['bro ciri ciri cebong adu domba sok lugu nama cebong buzzer receh xf0 x9f x98 x82 xf0 x9f x98 x82 xf0 x9f x98 x82']	negative
(DETIKCOM | Jangan Buru-buru Tolak Wacana Pilkada Lewat DPRD) #pemilu #pemilu2019	['detikcom buru buru tolak wacana pilih kepala daerah dewan wakil rakyat daerah pilih pilih 2019']	negative
RT USER Prabowo sdh tua perlu generasi muda yg bisa blusukan dan Jokowi msh muda dan saat ini sering blusukan diberbagai pulau	['prabowo tua generasi muda blusuk jokowi muda blusuk bagai pulau']	neutral
"Mohon Maaf""; Kalau Sekarang Pemilihan PRESIDEN anda Memilih Siapa; Bpk Jokowi : Like; Bpk Prabowo : RT;,0,0,0,0,0,0,0,0,0,0,0,0;;;;;;;;;;;;"	['mohon maaf pilih presiden pilih jokowi like prabowo 0 0 0 0 0 0 0 0 0 0 0 0']	negative
napadah shopee kampang'	['dah shopee kampang']	neutral
lu baca bandingkan modal dgn hasil diperpanjang atau tidak dasar antek asing	['baca banding modal hasil panjang dasar antek asing']	negative
USER Kerjaan? Tugas prakarya seni budaya? :3	['kerja tugas prakarya seni budaya 3']	neutral
USER kolam buaya kagak ada qey'	['kolam buaya oke']	neutral
USER Yu...mari kita songsong presiden baru ditahun 2019	['yu mari songsong presiden 2019']	neutral
"USER USER Mana mungkin w bani ngepost milik orang lain nik--""',0,0,0,0,0,0,0,0,0,0,0,0;;;;;;;;;;;;"	['gue bani ngepost milik orang nik 0 0 0 0 0 0 0 0 0 0 0 0']	negative
USER USER Cebong tidak akan pernah senang lihat kejayaan pk anis mereka akan ttp sirik. Yg parahnya klu junjungan dipuji habis habisan meskipun melakukan hal buruk.'	['cebong senang lihat jaya anis sirik parah junjung puji habis habis buruk']	negative
RT USER: USER Klo busuk mawati beragama islam .. Maka dia Takut dg dirinya sendiri\nGejala gila nich nenek ..'	['busuk mawati agama islam takut gejala gila nih nenek']	negative
ini jalan dua platform ya\ndi fb juga jalan\nbom yang gede klo mau dapet'	['jalan platform ya mana facebook jalan bom gede']	negative
Dikira org katolik coba:('	['orang katolik coba']	negative
USER berarti lo cacat'	['bera i cacat']	negative
USER USER USER USER USER Hahahaha roti buaya mah buat nikahan pak'	['haha roti buaya nikah']	neutral
USER USER luhut bajingan'	['luhut bajing']	negative
Me every night:\nAAAAA ANJENG GUE MALU BANGSAD. MAU ILANG AJA. AAAAAAAAA. APAAN SIH GUE JIJIK BANGET. AAAAAAAAA. INI APAAN SIH GUE DULU NGGAK DANTA. AAAAAAAAAAA. MAU ILANG AJA. AAAAAAAAAAAAAAA.'	['me every night naaaaa anjing gue malu bangsat hilang aaaaaaaaa sih gue jijik banget aaaaaaaaa sih gue danta aaaaaaaaaaa hilang aaaaaaaaaaaaaaa']	negative
USER Terus??\nAlus nya di puji. Butut nya disebut butut. Goblog disebut goblog.'	['kalong nya puji butut nya butut goblok goblok']	negative
Yang sabar gua mah punya adek2 kunyuk yg bau kek sempak kuda'	['sabar gue adek adek kunyuk bau kayak sempak kuda']	negative
Tuhan itu iBlis . Iblis itu Tuhan . Agama onta'	['tuhan iblis iblis tuhan agama onta']	negative
USER USER USER USER USER USER USER USER Assalamu alaikm ibu USER tlng hrp bantuanx u kmi #korbanphkfreeport	['asalamualaikum alaykum tolong harap bantu korbanphkfreepo']	neutral
RT USER USER Para jendral propaganda mereka perang propaganda dgn jualan utamanya pki dan cinaisasi..	['jenderal propaganda perang propaganda jual utama partai komunis indonesia cina']	negative
USER Ngentot donk'	['ngentot']	negative
"Pesan Presiden Joko Widodo,""Saya meyakini Negara kita Indonesia akan semakin besar dan kuat apabila Ulama dan Umaro beriringan"". Selengkapnya terlait pesan Bapak Presiden simak video berikut ini #JokowiSilaturahmidenganUlama..#JokowiCintaUlama..#JokowiAja,0,0,0,0,0,0,0,0,0,0,0,0;;;;;;;;;;;;"	['pesan presiden joko widodo negara indonesia kuat ulama umara iring lengkap kait pesan presiden simak video jokowi silaturahmi ulama jokowi cinta ulama jokowi 0 0 0 0 0 0 0 0 0 0 0 0']	negative
NGAKAK! Para barisan cebong sakit hati mau pake isu saracen utk nyerang Anies-Sandi agar gagal dilantik	['tertawa baris cebong sakit hati pakai isu saracen serang anies sandi gagal lantik']	negative
RT USER USER Prabowo simulut busuk Rizieq anies Fadlizon Fahri mereka kumpulan sampah negara jd kelakuan mereka juga kaya sampah	['prabowo si mulut busuk rizieq anies fadli zon fahri kumpul sampah negara laku kayak sampah']	negative
USER Betul , lalu knp tdk ada hindu nusantara,budha nusantara,khonghucu nusantara.kristen nusantars..Whats wrong? Why? Coba argumennya prof sambil ngopi &amp; guyon2\xf0\x9f\x98\x82',0,0,0,0,0,0,0,0,0,0,0,0;;;;;;;;;;;;	['hindu nusantara buddha nusantara konghucu nusantara kristen nusantara salah coba argumen prof minum kopi amp ketawa ketawa xf0 x9f x98 x82 0 0 0 0 0 0 0 0 0 0 0 0']	negative
Masih aja ada 'Orang Berpendidikan' berpikir Ekonomi syari'ah adalah ekonomi pembangunan para ekstrimis	['orang didik pikir ekonomi syariat ah ekonomi bangun ekstremis']	negative
USER waktu itu blm ada buzzer idiot...'	['buzzer idiot']	negative
Cagub Jabar Bicara Soal Toleransi di Muzakarah ICMI Jabar	['calon gubernur jabar bicara toleransi muzakarah ikat cendekiawan muslim indonesia jabar']	neutral
Cuma manusia otak dungu yg sekarang ini teriak-teriak 'bubarkan pki' buku buat dibaca!! Jgn bodoh! Otak kosong mulut nyap nyap!	['manusia otak dungu teriak teriak bubar partai komunis indonesia buku baca bodoh otak kosong mulut iya iya']	negative
Kisah pengemis yahudi buta\xf0\x9f\x98\xa2'	['kisah emis yahudi buta xf0 x9f x98 xa2']	negative
Pelaksanaan Makin dekat, Presiden Jokowi Minta Promosi #AsianGames2018 Digencarkan USER #ratas â?¡ï¸? â??Presiden Minta Promosi Asian Games Makin Gencarâ??; ;,0,0,0,0,0,0,0,0,0,0,0,0;;;;;;;;;;;;	['laksana presiden jokowi promosi asi games 2018 gencar ratas presiden promosi asi games gencar 0 0 0 0 0 0 0 0 0 0 0 0']	negative
USER cebong emang jagonya bikin dan sebar hoax'	['cebong jago bikin sebar hoaks']	negative
Kreatifitas masyarakat Desa Berdaya USER itu tiada batas, dan mampu meningkatkan prekonomian serta menghidupkan roda ekonomi mikro di desa.; salam berdaya dari Desa Sengon,Prambanan.; #SharingHappiness,0,0,0,0,0,0,0,0,0,0,0,0;;;;;;;;;;;;	['kreativitas masyarakat desa daya tiada batas tingkat ekonomi a hidup roda ekonomi mikro desa salam daya desa sengon prambanan bagi bahagia 0 0 0 0 0 0 0 0 0 0 0 0']	negative
Setelah kasus PKI di LBH rame-rame antek komunis membuat opini dan steitmen mengaburkan kebangkitan PKI	['partai komunis indonesia ramai ramai antek komunis opini nyata abur bangkit partai komunis indonesia']	negative
Revisi hukum pidana dengan memasukkan klausul mengenai PSK sukarela sudah sangat dibutuhkan. Indonesia yang gencar mempromosikan diri sebagai surga wisata internasional senyatanya perlu memagari... URL	['revisi hukum pidana masuk klausul kerja seks komersial sukarela butuh indonesia gencar promosi surga wisata internasional nyata pagar uniform resource locator']	neutral
"RT RPGpedia ""Gubernur Jaman Now dekat dengan Rakyat pilih nomor 1; ; #KamiGanjarYasin ; #KandangBant3ng; ; Salamnya; #TemannyaRPG; #namakuRUDY; #TemannyaRUDY,0,0,0,0,0,0,0,0,0,0,0,0;;;;;;;;;;;;"	['rpgpedia gubernur jaman now rakyat pilih nomor 1 ganjar yasin kandang banteng salam teman role playing game nama rudy teman ruddy 0 0 0 0 0 0 0 0 0 0 0 0']	negative
USER WOI BOLOT'	['woi bolot']	negative
Kenapa USER bicaranya sesuatu yg remeh temeh spt masalah kalajengking krn belio tau oposisinya spt USER itu pasti nyinyir jd stress dan stroke sendiri...krn emang dosen ga laku...bacot gede hasil karya ga ada... bahkan anak asuhnya mayor dungu	['bicara remeh temeh surat pemberitahuan tahun kalajengking beliau tau oposisi surat pemberitahuan tahun nyinyir stres strok dosen laku bacot gede hasil karya anak asuh mayor dungu']	negative
"""Keanekaragaman budaya, suku, agama, itulah sesungguhnya kekayaan kita,â?? tutur Djarot di hadapan peserta Rakercabsus PDI_Perjuangan Kota Gunungsitoli.; ; #GubernurZamanNow ; #DjarotSihar2 ; #SumutPilih2Djoss #DjarotSiharMenang #GunungSitoli #PDIPerjuangan,0,0,0,0,0,0,0,0,0,0,0,0;;;;;;;;;;;;"	['keanekaragaman budaya suku agama sungguh kaya djarot hadap pese a rapat kerja cabang khusus partai demokrasi indonesia juang kota gunung sitoli gubernur zaman now djarot sihar 2 sumatra utara pilih jos djarot sihar menang gunung sitoli partai demokrasi indonesia juang 0 0 0 0 0 0 0 0 0 0 0 0']	negative
"USER USER USER Setipe sama yang dibelain. \nKata andalan ""cebong"" adalah pemuas syahwatnya \xf0\x9f\x98\x82\xf0\x9f\x98\x82\xf0\x9f\x98\x82',0,0,0,0,0,0,0,0,0,0,0,0;;;;;;;;;;;;"	['tipe bela andal cebong muas syahwat xf0 x9f x98 x82 xf0 x9f x98 x82 xf0 x9f x98 x82 0 0 0 0 0 0 0 0 0 0 0 0']	negative
USER USER USER USER hehe typical bani pekok. ga bs bantah trs danga dungu dah.'	['hehe tipikal bani bodoh bantah danga dungu']	negative
"USER USER USER ~improvisasi itu lagu..al Qur'an itu tafsir..masak susah mikir gituan..murotal itu improv..Tilawatil Qur'an itu improv..raut mukamu itu tafsir..cara kentutmu itu tafsir..cara ngentot aja tafsir..cara kawin itu tafsir...ngaji yg bener.!!"",1,1,1,0,0,0,0,0,1,1,0,0;;;;;;;;;;;;"	['improvisasi lagu al qur an tafsir masak susah pikir murottal tingkat tilawatil qur an tingkat raut muka tafsir kentut tafsir ngentot tafsir kawin tafsir aji 1 1 1 0 0 0 0 0 1 1 0 0']	negative
SEMOGA KITA TERMASUK ORANG2 DENGAN WAJAH YG BERSERI2 ð??? #JumatBerkah; ; Ù?Ù?Ø¬Ù?Ù?Ù?Ù? Ù?Ù?Ù?Ù?Ù?Ù?Ø¦Ù?Ø°Ù? Ù?Ù?Ù?Ø§Ø¶Ù?Ø±Ù?Ø©Ù?; Wajah-wajahÂ (orang-orang mukmin) pada hari itu berseri-seri.(Al-qiyamah: 22); Ù?Ù?Ù?Ù?Ø¬Ù?Ù?Ù?Ù? Ù?Ù?Ù?Ù?Ù?Ù?Ø¦Ù?Ø°Ù? Ø¨Ù?Ø§Ø³Ù?Ø±Ù?Ø©Ù?; DanÂ wajah-wajahÂ (orang kafir) pada hari itu	['moga orang orang wajah seri seri jumat berkah wajah wajah orang orang mukmin seri seri al qiyamah 22 wajah wajah orang kafir']	neutral
USER USER Yang panik itu yang mau ganti presiden tapi g tau calonnya siapa! Ups mungkin karena g bisa berbuat banyak!!!!! Karena dibawah kepemimpinan pak USER banyak koruptor tertangkap!!! Jadi mau ganti presiden!!! Siapa tau bisa di nego!!	['panik ganti presiden tau calon ups buat pimpin koruptor te angkap ganti presiden tau negosiasi']	negative
Haruskah aku buat thread jadi TKI dimalaysia dengan jam kerja 16jam? Sebenernya ini kilang memang jahanam betol'	['harus thread tenaga kerja indonesia malaysia jam kerja enam belas jam kilang jahanam']	neutral
.; Ekonomi : hancur; Subsidi : dicabut; BBM : mahal; Listrik : naik tdk karuan; Sembako : tak terjangkau rakyat; Politik : kisruh terus; Agama : dinistakan terus; Kebijakan : tdk pro rakyat; HAM : terbengkalai; Leadership : LEMAH; ; Dua periode?	['ekonomi hancur subsidi cabut bahan bakar minyak mahal listrik karuan sembako jangkau rakyat politik kisruh agama nista bijak pro rakyat ham bengkalai leadership lemah periode']	negative
USER USER Dan Indonesia harus menghormati AS!!\n\nNtu sape nyang kemaren ngomong begitu??\nWahhh dr roman2nye pasti antek ASING tuh'	['indonesia hormat as kemarin bicara nwahhh roman roman antek asing']	negative
dr. Sam Aliano; ; Calon Presiden 2019.; ; Indonesia Bebas Hutang. â??; Indonesia Bubar Pas Kiamat. â??; Umroh Gratis per 1 Orang. â??	['aliano calon presiden 2019 indonesia bebas hutang indonesia bubar pas kiamat umrah gratis 1 orang']	neutral
USER USER USER USER Pencipta hoaxs ya presiden dan wakilnya'	['cipta hoaks ya presiden wakil']	negative
Muncul sudah antek antek PKI dah berani muncul terang-terangan mudah-mudah pemerintah tidak tinggal diam. URL	['muncul antek antek partai komunis indonesia berani muncul terang terang mudah mudah perintah tinggal diam uniform resource locator']	negative
USER 1. Mengandung ekstrak lidah buaya \n2. Tidak mengandung Alkohol\n3. Memiliki rasa manis\n4. Tidak bereaksi terhadap obat lain\n5. Aman digunakan untuk anak2 &amp; bayi\n6. Kemasan finger off yg tak bersentuhan dgn luka\n7. Tidak perih pada l	['1 kandung ekstrak lidah buaya n2 kandung alkohol n3 milik manis n4 reaksi obat n5 aman anak anak amp bayi n6 kemas finger off sentuh luka n7 perih l']	neutral
USER onta ya bukan aku\xf0\x9f\x98\x92'	['onta ya xf0 x9f x98 x92']	negative
Bagaimana perasaan walubi kalo umat budha di indonesia yg di usir dan di bantai???	['asa walubi umat buddha indonesia usir bantai']	negative
USER Giliran ambruk cuma planga plongo kaya ayam kena tetelo ?? USER ; ; #Putin; #PrabowoUntukIndonesia; #2019GantiPresiden	['gilir ambruk plonga plongo kayak ayam kena tetelo putin prabowo indonesia 2019 ganti presiden']	neutral
Beda kristen dg agama lain>siapa yg percaya YESUS sbg Juruslamat& Tuhan! Mk menerima ROH KUDUS-sbg Penolong& Penghibur! *bkn dg kekuatan qt*	['beda kristen agama percaya yesus juru selamat tuhan mk terima roh kudus tolong hibur kuat']	negative
PRESIDEN SOEHARTO AKAN RESMIKAN TIGA MUSEUM DIÂ TMII	['presiden soeha o resmi museum taman mini indonesia indah']	neutral
USER USER USER Lu nyindir pak de? ?. #2019GantiPresiden	['sindir deh 2019 ganti presiden']	neutral
Presiden Jokowi Sebut Soft Launching Bandara Kertajati 24 Mei	['presiden jokowi lembut launching bandara ajati 24 mei']	neutral
"USER USER USER USER Gini umat islam di bodohi pake kata fiksi. Dan alasan salman rusdhi mbuat ""the santanicverse"" berasal pembodohan seperti ini. Fiksi itu imanijer *angan2. Kalau tujuan untuk membela USER banyak nara,0,0,0,0,0,0,0,0,0,0,0,0;;;;;;;;;;;;"	['umat islam bodoh pakai fiksi alas salman rusdhi the satanic verse asal bodoh sepe i fiksi imajiner angan angan tuju bela nara 0 0 0 0 0 0 0 0 0 0 0 0']	negative
USER USER KAMU LAH HOMO YG PALING SIAL BAJINGAN GOBLOK...KALAU TERLALU GIAN KAMU AMPUT ANJING DITEPI JALAN TU.....SEMOGA KAMU TERIMA BALASAN NYA NANTI...'	['homo sial bajing goblok gian amput anjing tepi jalan moga terima balas nya']	negative
Mengajak anak-anak dalam peledakan bom tidak mungkin muncul dari orang yang memahami Islam. Itu tindakan keji.\n - Aman Abdurrahman'	['ajak anak anak ledak bom muncul orang paham islam tindak keji aman abdurrahman']	neutral
USER Alah kntl'	['alah kontol']	negative
USER Gi ngocok memek say'	['kocok memek sayang']	positive
USER Gue baru nyadar kalo situ baru ngefollowback saya. Kelamaan umroh ya? Mana oleh-oleh onta mekkah? Iya salam kenal Dav.'	['gue sadar situ ikut umrah ya onta makkah iya salam kenal dav']	negative
USER Bubarkan saja kpk biar leluasa para koruptor memperkaya diri di Negri ini	['bubar komisi berantas korupsi biar leluasa koruptor kaya negeri']	negative
USER Cuma rezim ini org kaya dia berani tampil di layar kaca. Mohon segera ambil tindakan USER USER	['rezim orang kayak berani tampil layar kaca mohon ambil tindak']	negative
RT USER mmg otoriter! Buktinya USER selalu OTT? Pdhal dri partai politiknya sendiri byk ya? USER & USER Ditangkap smua?	['otoriter bukti ott ai politik ya tangkap']	neutral
USER USER USER USER USER USER USER Cebong itu badut nya China \xf0\x9f\xa4\xaa\xf0\x9f\xa4\xaa\xf0\x9f\x98\x81\xf0\x9f\x98\x81\xf0\x9f\x98\x81 cuma dikipasin sama uang recehan galaknya bukan main\xf0\x	['cebong badut nya cina xf0 x9f xa4 xaa xf0 x9f xa4 xaa xf0 x9f x98 x81 xf0 x9f x98 x81 xf0 x9f x98 x81 kipas uang receh galak main xf0 x']	negative
CEPAT BERIKAN AKU BEBERAPA EKOR CHANGBIN HYUNK. PENGEN DIBULLY SAMPE TITIT DARAH PENGHABISAN'	['cepat ekor changbin hyung dibully titit darah habis']	positive
USER USER USER USER USER USER USER USER USER USER USER USER USER USER USER USER USER USER USER USER Salah	['salah']	negative
"USER + fed well\n+ benar benar memotivasi\n+ jarang rebutan bias\n+ dapet merch dia gampang dan lumayan murce\n\n- di bilang lesbi\n- ""cOwOknYa kOk cANtik""',0,0,0,0,0,0,0,0,0,0,0,0;;;;;;;;;;;;"	['fed well motivasi jarang rebut bias merch gampang lumayan murah bilang lesbi cowok cantik 0 0 0 0 0 0 0 0 0 0 0 0']	negative
USER iya juga ya pertanyaan bg USER ini. lantas kami menyebut org yg bkn beragama islam dgn sebutan apa? knp sebut non muslim gk terima. aneh2 aja rezim ini.. zaman pak beye dulu gk ada yg kek beginian. #TepokJidat. ya sdh la intinya #20	['iya ya pe anyaan lantas sebut orang agama islam sebut non muslim terima aneh aneh rezim zaman susilo bambang yudhoyono kayak tepuk jidat ya inti 20']	negative
Ini orang ga tau Islam, tp belagu dan asbun.; ; Pidato Jokowi udah sesuai ayat Qur'an: Allah tak akan ubah nasib suatu kaum kecuali mrk mengubahnya. ; ; Kalo mau ganti presiden, rakyat sendiri yg harus mengganti. Baru Tuhan mengganti. Kehendak rakyat dulu,,1,1,1,0,1,0,0,0,0,1,0,0;;;;;;;;;;;;	['orang tau islam belaga bunyi pidato jokowi sesuai ayat qur an allah ubah nasib kaum kecuali ubah ganti presiden rakyat ganti tuhan ganti hendak rakyat 1 1 1 0 1 0 0 0 0 1 0 0']	negative
Perasaan kemarin2 pake Axis aman2 aja deh di rumah. Kok 2 minggu ini kacrut kali sih jaringannya -_-*'	['asa kemarin kemarin pakai axis aman aman deh rumah 2 minggu kacrut kali sih jaring']	negative
Gak enak bego dituduh-tuduh sama sesuatu hal yg gak pernah gue lakuin!'	['enak bego tuduh tuduh gue laku']	negative
punya otak? taruh dimana? pasti taruh di congor lo kan?'	['otak taruh mana taruh congor']	negative
USER USER Si Terdakwa Penista Agama Alias Si Ahok Babi Jamban tuh yang Morfotin Uang Rakyat Jakarta	['sih dakwa nista agama alias sih ahok babi jamban morfin uang rakyat jaka a']	negative
USER Lah lu bom apa gimana?jauh jauh dah gua nih takut'	['bom gue nih takut']	negative
Yakinlah gabungan yang disokong tetap berkesan; ; Oleh itu tolonglah kami untuk menolong kamu; ; Kerana akhirnya nikmat usaha ini adalah untuk semua; ; Kamu untuk kami, kami untuk kamu; ; Untuk bangsa, agama dan negara.; ; SOKONGLAH PAKATAN HARAPAN!,0,0,0,0,0,0,0,0,0,0,0,0;;;;;;;;;;;;	['yakin gabung sokong kesan tolong tolong ranah nikmat usaha bangsa agama negara sokong pakat harap 0 0 0 0 0 0 0 0 0 0 0 0']	negative
Gils ada yg jual pc jucan 100 aja w mikir2 wkwkkw\nEdan'	['gila jual pc jucan 100 gue pikir wkwk edan']	positive
sadar gak se lepas sepatu tp masi kaos kaki iku bau banget woiii yaampun kyk ambu silit'	['sadar lepas sepatu kaos kaki bau banget woiii ya ampun kayak ambu silit']	negative
USER Najis sok banget jutek iyuuuh. Gua mau nyanyk aja..'	['najis sok banget jutek iyuuuh gue yanyk']	negative
"""Sekali-kali tidak akan masuk surga kecuali orang-orang Yahudi atau Nasrani"". Demikian itu (hanya) angan-angan kosong belaka"" (QS 2:111)',0,0,0,0,0,0,0,0,0,0,0,0;;;;;;;;;;;;"	['kali masuk surga kecuali orang orang yahudi nasrani angan angan kosong belaka qs 2 111 0 0 0 0 0 0 0 0 0 0 0 0']	negative
Bubarkan saja tuh DPR sama KPK...sama aja bodoh nya	['bubar dewan wakil rakyat komisi berantas korupsi bodoh nya']	negative
RT USER: Brondong SMP kontol cakep panjang! Croott URL	['berondong kontol cakap crot uniform resource locator']	negative
Tapi apa aku tahu.. \nRamai hanya mampu bisu.. \nTak mahu buang malu.. \nTakut kepala tembus peluru..'	['ramai bisu buang malu takut kepala tembus peluru']	negative
#TolakPerpresTKA; #TolakPerpresTKA; #2019GantiPresiden; #2019PresidenBaru; ; Hai mahasiswa Indonesia, nih ada hadiah lipstik dan kolor untuk kalian dari seorang kakek tukang beca,1,0,0,1,0,0,0,0,1,0,1,0;;;;;;;;;;;;	['tolak atur presiden tenaga kerja asing tolak atur presiden tenaga kerja asing 2019 ganti presiden 2019 presiden hai mahasiswa indonesia nih hadiah lipstik kolor kakek tukang becak 1 0 0 1 0 0 0 0 1 0 1 0']	negative
USER Kelakar kan hahhaha mmg klaka pon sbb cerita cinta monyet masa skolah menengah \xf0\x9f\xa4\xa3'	['kelakar haha klaka pon cerita cinta monyet sekolah tengah xf0 x9f xa4 xa3']	negative
USER USER \xc2\xab diem lu buaya.'	['xc2 xab diam buaya']	negative
Para pendukung rejim 2 periode mulai sering viralin ceramah dan wawancaranya TGB...\xf0\x9f\x98\x82\xf0\x9f\x98\x82\xf0\x9f\x98\x82\xf0\x9f\x98\x82'	['dukung rejim 2 periode viralkan ceramah wawancara tuan guru bajang xf0 x9f x98 x82 xf0 x9f x98 x82 xf0 x9f x98 x82 xf0 x9f x98 x82']	negative
"USER Anak pmr calon dokter gk cupu :'("",0,0,0,0,0,0,0,0,0,0,0,0;;;;;;;;;;;;"	['anak pmr calon dokter cupu 0 0 0 0 0 0 0 0 0 0 0 0']	negative
Penghina Keluarga Jokowi Langsung Diciduk Giliran Penghina Prabowo SBY dibiarin aja	['hina keluarga jokowi langsung ciduk gilir hina prabowo susilo bambang yudhoyono biar']	neutral
USER bani koplak mana nich kok gak dukung siwanbango bego'	['bani kocak nih dukung siwanbango bego']	negative
Hahahahhahaa silvy ohh silvy cacingan amat loe ahhh wkwkwkwkwkk #DebatFinalPilkadaJKT	['haha silvy oh silvy cacing ah wkwk debat final pilih kepala daerah jakarta']	negative
USER Ayok kawan kita berangkat\nNaek delman atau onta\xf0\x9f\x98\x82'	['ayo kawan berangkat delman onta xf0 x9f x98 x82']	negative
Gubernur yang patuh lapor LHKPN #GanjarYasin1 #KamiGanjarYasin	['gubernur patuh lapor lapor harta kaya selenggara negara ganjar yasin 1 ganjar yasin']	neutral
USER mau bukti ke RADIKAL an HTI dan FPI?!; apa kurang bukti di setiap orasi-orasinya HTI dan FPI selalu memfitnah dan caci maki terhadap pemerintah,POLRI bahkan ULAMA'/KYAI-KYAI!!! ; dasar otak bebek pura-pura buta dan tuli dengan isi otak junj,1,1,0,1,1,0,1,0,0,0,1,0;;;;;;;;;;;;	['bukti radikal an hati front bela islam bukti orasi orasi hati front bela islam fitnah caci maki perintah polisi republik indonesia ulama kiai kiai dasar otak bebek pura pura buta tuli isi otak junj 1 1 0 1 1 0 1 0 0 0 1 0']	negative
Bahas Islam merusak nilai USER penguatan karakter melalui revitalisasi pendidikan nilai	['bahas islam rusak nilai kuat karakter revitalisasi didik nilai']	negative
bagus....nanti dipakai untuk petisi lengserkan Jokowi ya KembalikanAhokKeCipinang	['bagus pakai petisi lengser jokowi ya kembali ahok cipinang']	positive
RT USER Semoga dimasa depan etnis cina di Indonesia tetap tdk menduduki pemerintahan.. bisa jadi kayak Singapur :)	['moga etnis cina indonesia duduk perintah kayak singapura']	negative
Monyet beneran mati ini mah:)) USER URL	['monyet benar mati uniform resource locator']	negative
Sepandai pandainya kita menyembunyikan bangkai pasti akan tercium juga baunya haha \xf0\x9f\x99\x8a'	['pandai pandai sembunyi bangkai cium bau haha xf0 x9f x99 x8a']	negative
USER USER USER trus Islam ga punya kitab suci?; kok logika lu jatuh ke palung jawa gitu modelnya; tau arti kata fiksi menurut kbbi belum?	['islam kitab suci logika jatuh palung jawa model tau a i fiksi kamus bahasa indonesia']	negative
RT USER Mungkin kata USER: yg dilakukan Raja Salman hanya pencitraan	['raja salman citra']	neutral
USER Untuk mengedukasi manusya2 udik seperti qm misalnya'	['edukasi manusia manusia udik sepe i']	negative
bi dorong pembiayaan syariah untuk pembangunan	['bi dorong biaya syariat bangun']	positive
Nih ya gue jelasin. \n\nCowo. Burungnya gaada. Jadi cewe. Cewenya bernada2. \n\nSIAPA LAGI TRANSGENDER DI INDONESIA YG NYANYI? URL	['nih ya gue cowok burung cewek cewek nada nada transgender indonesia nyanyi uniform resource locator']	negative
USER USER Indonesia sedang di jajah cina...	['indonesia jajah cina']	negative
RT USER Bubarkan DPR gak butuh	['bubar dewan wakil rakyat butuh']	negative
USER NGAKAK NGAPAIN NANYA SAMA GW TAE MINTA DIGAMPAR'	['tertawa gue tai gampar']	negative
USER USER USER Cocot cocot cocot. 2019 bubarin grindra'	['cocot cocot cocot 2019 bubar gerindra']	negative
USER Ayoo ngewe'	['ayo ngewe']	negative
USER yang sampe Januari 1998 masih bilang Anti-Suharto gerakan Komunis yah?'	['januari 1998 bilang anti suha o gera komunis ya']	neutral
USER USER USER USER Gak usah sok bijak. Smua mata sdh liat gimana kebobrokan hukum saat ini. Rakyat sdh bisa menilai loh. Gk bego. Kita lihat nanti #2019GantiPresiden'	['sok bijak mata lihat bobrok hukum rakyat nilai bego lihat 2019 ganti presiden']	negative
RT USER: USER Burma dan Budha memang teroris sebenarnya	['burma buddha teroris']	negative
Hooo keliatan mana yg bego sekarang hahaha'	['hooo bego haha']	negative
Ustadz USER memang penggemar &amp; penggerak olah raga bersepeda di Bekasi. MantaPKS! #20TahunPKS #Asyik	['ustaz gemar amp gerak olah raga sepeda bekas mantap 20 pks asyik']	positive
USER Hehehe emang kampang fandom itu'	['hehe kampang fandom']	negative
USER naek onta kapan nyampe nya\xf0\x9f\x98\xa5'	['onta nya xf0 x9f x98 xa5']	negative
"USER Kalau orang2 yang bawa bom ngaku cuma ""ngetes pak pol"" ... Boleh juga Kali ya pak..hehe, apa kabar pa Ronald',0,0,0,0,0,0,0,0,0,0,0,0;;;;;;;;;;;;"	['orang orang bawa bom aku ketes pol kali ya hehe kabar ronald 0 0 0 0 0 0 0 0 0 0 0 0']	negative
USER USER Akhlak mulia presiden USER kl bertemu kiai dan pinisepuh maka ia tak akan menggulung lengan kemejanya. Karena mereka memang sngat pantas dihormati.. .. *tabik	['akhlak mulia presiden be emu kiai pinisepuh gulung lengan kemeja hormat tabik']	negative
ios asw napada ]]'	['ios anjing']	negative
USER Yaudah gwe mau demo minta pak Jokowi ngekick palkjihun dari dunia.	['ya gue demo jokowi tendang palkjihun dunia']	negative
USER Sy jg muak sm lu yg fitnah prabowo	['muak fitnah prabowo']	negative
"USER Maraknya org\xc2\xb2 sipit masuk ke Indonesia hanya pengalihan. Hati\xc2\xb2lah justru kepada Syi'ah rafidhah, biang keroknya segala pemberontakan/kudeta negara\xc2\xb2 muslim ahlussunah di dunia"",1,0,0,1,1,1,0,0,0,0,1,0;;;;;;;;;;;;"	['marak orang xc2 xb2 sipit masuk indonesia alih hati xc2 xb2lah syiah ah rafidhah biang kerok ronta kudeta negara xc2 xb2 muslim ahlusunah dunia 1 0 0 1 1 1 0 0 0 0 1 0']	negative
Ketua DPR Dorong Inspirasi Kreatif Pemerintah Sesuai BudayaÂ Pancasila	['ketua dewan wakil rakyat dorong inspirasi kreatif perintah sesuai budaya pancasila']	neutral
"Gubernur Ahmad Heryawan mengukir sejarah. Bandara super megah ""Kertajati"" dibangun dengan biaya mandiri tanpa menggunakan APBN, murni dikelola oleh Pemprov #JawaBarat. Ini sejarah baru infrastruktur bagi Indonesia.;,0,0,0,0,0,0,0,0,0,0,0,0;;;;;;;;;;;;"	['gubernur ahmad heryawan ukir sejarah bandara super megah ajati bangun biaya mandiri anggar dapat belanja negara murni kelola perintah provinsi jawa barat sejarah infrastruktur indonesia 0 0 0 0 0 0 0 0 0 0 0 0']	negative
USER kaya TAI'	['kayak tai']	negative
&lt; bertanya-tanya, apa yang dirinya lakukan di kehidupan sebelumnya sampai-sampai harus bertemu dengan pria asing dan nenyebalkan ini? \n\nDi samping nada bicara sang teruna, Angie juga tidak senang dengan cara pria itu memanggilnya 'non'. Ia mengerti,0,0,0,0,0,0,0,0,0,0,0,0;;;;;;;;;;;;	['lt be anya laku hidup be emu pria asing sebal mana samping nada bicara sang teruna angie senang pria panggil non menge i 0 0 0 0 0 0 0 0 0 0 0 0']	negative
RT USER Juga jago bakar isu PKI Komunis	['jago bakar isu partai komunis indonesia komunis']	negative
"WASPADA JATENG!!!; Indikasi akan ada mobilisasi massa dri luar jateng untk tamasya pilkada!!!; ; ""Temuan Panwas Brebes, Ada 1 NKK dengan 946 Anggota Keluarga""; USER; USER USER USER USER USER USER,0,0,0,0,0,0,0,0,0,0,0,0;;;;;;;;;;;;"	['waspada jawa indikasi mobilisasi massa jawa tamasya pilih kepala daerah temu panitia awas brebes 1 nkk 946 anggota keluarga 0 0 0 0 0 0 0 0 0 0 0 0']	negative
Bilang sama suami elo USER jangan cengeng suka blok orang oke. Katanya politisi top mantan timses kafir penista agama tapi kok kelakuan cemen. Katanya liberal tapi kok partisan ngehek.	['bilang suami cengeng suka blok orang oke politis top mantan tim sukses kafir nista agama laku takut liberal isan ngehek']	negative
MEMANG ANAK ANJING KAMPANG'	['anak anjing kampang']	negative
USER .... bani kampret .... bani kecebong........ pilih bani adam lah...... soale manusia'	['bani kampret bani kecebong pilih bani adam manusia']	negative
USER USER Kalau gw guna kan kampret kaga bisa ngeliat bro siang hari gimame si lollll'	['gue kampret bro siang sih lollll']	positive
Presiden Joko Widodo memutuskan untuk lebih realisitis dalam mengejar pembangunan Proyek Strategis Nasional (PSN).â?¦â?¦	['presiden joko widodo putus realisitis kejar bangun proyek strategis nasional play station network']	neutral
USER USER USER USER USER USER USER REZIM SALES REZIM PENIPU PENCITRAAN SEMUA PALSU'	['rezim sales rezim tipu citra palsu']	negative
USER Jijik gua cowo2 pake baju pink2\n\nPERNAH GUA NONTON VIDKEP KAN YA. GUA KIRA CEWE. KAKINYA MUNGIL. PAKE KAOS KAKI YANG SEPAHA ITU WARNA PINK. PAKE BAJU PINK YANG PANJANG SAMPE SEPAHA\n\nPAS DIBUKA ISINYA TITIT. ASUUUUU'	['jijik gue cowok cowok pakai baju merah muda gue tonton video bokep ya gue cewek kaki mungil pakai kaos kaki paha warna merah muda pakai baju merah muda paha pas buka isi titit asuuuuu']	negative
"USER Sungguh""rezim KOPLAK..indonesia sedang sekarat..umat muslim sdg di pilah""oleh Allah SWT..antara golongan muslimin dan munafiqun.,1,0,0,1,1,0,0,0,0,0,1,0;;;;;;;;;;;;"	['sungguh rezim kocak indonesia sekarat umat muslim pilah allah subhanahu wa taala golong muslimin munafik 1 0 0 1 1 0 0 0 0 0 1 0']	negative
USER USER USER USER Jancuk \xf0\x9f\x98\x82\xf0\x9f\x98\x82\xf0\x9f\x98\x82'	['jancuk xf0 x9f x98 x82 xf0 x9f x98 x82 xf0 x9f x98 x82']	negative
kalian ni ngapa sih nyinyirin yg hijrah padahal kan mrk cm maw nutupin koreng'	['nih sih nyinyir hijrah tutup koreng']	negative
RT USER pakai paksa-paksa jokowi balikin semua penduduk rakhin. Emang prabowo pengangguran. Banyak politikus nganggur jadi omongnya ngawur	['pakai paksa paksa jokowi kembali duduk rakhine prabowo anggur politikus anggur omong ngawur']	negative
USER ntar jatohnya musyrik tar ak masuk neraka:((	['jatuh musyrik tar masuk neraka']	negative
Mendampingi JOKOWI Di HARLAH PMII Di BANDUNG.. CAK IMIN Balik JAKARTA dengan PESAWAT KEPRESIDENAN BERSAMA PRESIDEN.. JOIN 2019; ; #CakIminTheNextWapres; #JOIN2019; ; USER USER; USER USER USER USER USER USER	['damping jokowi harlah gera mahasiswa islam indonesia bandung cak imin jaka a pesawat presiden presiden join 2019 cak imin the next wakil presiden join 2019']	neutral
USER Jualab kaos nggk laku kembali ke isu pki. Duhh gimana bisa maju'	['jual kaos laku isu partai komunis indonesia duh maju']	neutral
Jokowi USER Adalah Ahok Yang Tertunda siap-siap dipenjara juga ya pak URL	['jokowi ahok te unda penjara ya uniform resource locator']	neutral
Mengapa menggunakan bahasa Arab? Bukankah Tuhan YME menurut Pancasila berbahasa Indonesia?	['bahasa arab tuhan maha esa pancasila bahasa indonesia']	negative
USER Tapi perdebatan spt ini memang tidak dapat dihindari. Sejarah gereja pun mencatat perpecahan pertama dalam gereja terjadi waktu konsili yerusalem karena hal ini: Apakah tradisi yahudi merupakan bagian dari ajaran kristiani atau tidak?'	['debat surat pemberitahuan tahun hindar sejarah gereja catat pecah pe gereja konsili yerusalem tradisi yahudi ajar kristiani']	negative
Pantesan tim sukses Anies-Sandi ini kalo ngetwit ngaco sok jagoan	['tim sukses anies sandi mentwit kacau sok jago']	negative
USER Oii turo bom? Kajakkk'	['oi turonggo bom kajakkk']	negative
USER USER USER USER Waduh wanginya kek mbak kunti dong'	['wangi kayak mbak kunti']	negative
USER USER Bong dungu.. Cuma video 31 detik langsung ambil kesimpulan.. Kagak heran dah klo lu d sbut dungu sekolam..'	['bong dungu video 31 detik langsung ambil simpul heran dungu kolam']	neutral
Buat kalian yg pengen tau budaya Baduy, gue rencana Sabtu-minggu 14-15 April 2018 ke sana... palingan habis Rp300.000 an lah... kalo mau, kontak gue aja, kita jalan bareng. tp bkn #MaleTrip yaa; ;,0,0,0,0,0,0,0,0,0,0,0,0;;;;;;;;;;;;	['tau budaya badui gue rencana sabtu minggu 14 15 april 2018 paling habis rp300 000 an kontak gue jalan bareng male trip ya 0 0 0 0 0 0 0 0 0 0 0 0']	negative
USER USER Hahahahaha... \nga ada orderan demo.. \nga ada nasi bungkus.. \nga ada perbaikan gizi.. \nTETAP IDIOT..!'	['haha order demo nasi bungkus baik gizi idiot']	negative
USER USER Ketika generasi tinja sangat bahagia pemimpin nya bisa berkoar koar anti aseng di jaman pilkada dan ketika selesai pilkada pengikutnya membela bahwa tinja nya aseng enak'	['generasi tinja bahagia pimpin nya koar koar anti asing jaman pilih kepala daerah selesai pilih kepala daerah ikut bela tinja nya asing enak']	negative
USER Betul..anak anak PKI mulai muncul mengikuti jejak bapaknya.	['anak anak partai komunis indonesia muncul ikut jejak bapak']	negative
Sang maestro dan sang Capres/ cawapres RI 1 nih yg Pintar dan pro wong cillik dan tdk otoriter	['sang maestro sang calon presiden calon wakil presiden ri 1 nih pintar pro orang otoriter']	neutral
banyak lagi yg dihadapai Bung karno sampai beliau jatuh dari jabatanya demi kedaulatan Indonesia. itu dikarenakan Dia yang keras menolak modal asing. #Freeport51'	['hadap karno beliau jatuh jabat daulat indonesia keras tolak modal asing freepo 51']	positive
USER Menurut saya ente bule di rezim Jokowi ini cuma ada dua pilihan beri saham 51.38% atau 2021 angkat kaki dari bumi NKRI ..'	['bule rezim jokowi pilih saham 51 38 2021 angkat kaki bumi negara satu republik indonesia']	negative
USER USER USER USER inherit agama bro.. nasib terberanak dlm islam.. ð???ð???.; ; kalau tak ntah. kahkahkah	['inherit agama bro nasib anak islam haha']	negative
RT USER makin lama bikin puyeng kepala itu pak prabowo sama amin rais itu om nada-nada bicaranya nggak bermutu.sama sekali	['bikin puyeng kepala prabowo amin rais om nada nada bicara mutu']	neutral
USER USER ganyang pki. mari kita dukung prabowo untuk 2019	['ganyang partai komunis indonesia mari dukung prabowo 2019']	negative
USER Kalo sehati cacat dong?: ('	['sehat cacat']	negative
"USER USER USER USER USER USER USER USER Yang ku khawatirkan...\n\nKlo sampai TKA ini angkat senjata, atau ""menguasai"" desa (cuma tempat singgahan/markas (mungkin)...\n\nWilayah Indonesia Timur langs,0,0,0,0,0,0,0,0,0,0,0,0;;;;;;;;;;;;"	['ku khawatir tenaga kerja asing angkat senjata kuasa desa singgah markas wilayah indonesia timur langsung 0 0 0 0 0 0 0 0 0 0 0 0']	negative
USER Ternyata dgn d takut2inya oleh tim komunis akn d KPK kan akhirnya TGB nyerah k pngkuan zionis PKIP..'	['takut tim komunis komisi berantas korupsi tuan guru bajang serah k aku zionis pkip']	negative
Adaloh orang yang suka nyinyirin pecun di timeline tapi ngelike postingan akun open BO. \xe2\x98\xba'	['lo orang suka nyinyir pecun lini suka postingan akun open bo xe2 x98 xba']	negative
USER USER Etnis cina memang ada yg ikut berjuang tapi lebih sangat banyak yg jadi penghianat jd antek belanda..	['etnis cina juang khianat antek belanda']	negative
USER Lele jamban? Yg kuning kuning dong? :('	['lele jamban kuning kuning']	negative
"Malam ini Kepala #BPIP menjadi Pembicara bersama Menteri Agama, Rektor UIN Sumut dan Habib Jindan bin Novel dlm Mengaji Indonesia ""Kita Indonesia, Kita Berbudaya"", UIN Sumut, (Medan, 11/4/18),0,0,0,0,0,0,0,0,0,0,0,0;;;;;;;;;;;;"	['malam kepala badan bina ideologi pancasila bicara menteri agama rektor universitas islam negeri sumatra utara habib jindan bin novel aji indonesia indonesia budaya universitas islam negeri sumatra utara medan 11 4 18 0 0 0 0 0 0 0 0 0 0 0 0']	neutral
Bupati Jember Harapkan JFC 2018 jadi Semangat Geliat Ekonomi Kerakyatan.; ; Baca Selengkapnya Di:;	['bupati jember harap jfc 2018 semangat geliat ekonomi rakyat baca lengkap']	neutral
Mowaa mengatakan bahwa seluruh warga Nias akan memenangkan Djarot-Sihar di Pilkada Sumut 27 Juni nanti.; #NiasPilihDjoss	['mowaa warga nias menang djarot syiar pilih kepala daerah sumatra utara 27 juni nias pilih djarot sihar']	neutral
USER USER Apan jir?dahak?KWKWKW TOLOL'	['jir dahak wkwk tolol']	negative
USER USER USER Jika dulu tanpa Soeharto mungkin komunis sudah menguasai negeri ini. Agama tdk seperti skrng.	['soeha o komunis kuasa negeri agama sepe i']	negative
UU Antiterorisme sudah disahkan DPR. Kini aparat keamanan sudah memiliki payung hukum utk bertindak tegas dalam memerangi teroris.'	['undang undang anti terorisme sah dewan wakil rakyat aparat aman milik payung hukum be indak rang teroris']	negative
RT USER Ahok Taik. \ MENFITNAH\ . Emang lu tukang caci maki perempuannn!! Asuuu AhokPastiTumbang DebatFinalPilkadaJKT	['ahok tai fitnah tukang caci maki perempuannn anjing ahok tumbang debat final pilih kepala daerah jakarta']	negative
USER USER USER Fungsi GST utk mengurangkan beban kebergantungan kpd hasil petroleum negara..lagipun idea pelaksanaan GST datangnya dari Bank Negara bukan parti BN sendiri #GelombangBiru;	['fungsi goods and services tax kurang beban gantung hasil petroleum negara lagi ide laksana goods and services tax datang bank negara i bn gelombang biru']	neutral
Sikap ketakutan rezim di tunjukan melalui presidential threshold.\n\n#jumatberkah.'	['sikap takut rezim tunjuk presidential threshold jumat berkah']	negative
USER USER ridwal kamil memang hebat dan top nggak kaya ahok tukang penista agama dan koruptor	['ridwan kamil hebat top kayak ahok tukang nista agama koruptor']	negative
RT USER: USER Mereun dititah ku si Gunawan : sia asri ngaku kunyuk jadi aing nu keuna kehed.'	['titah ku sih gunawan asri aku kunyuk nu kena kehed']	positive
Betul itu kelihatannya JK mau main belakang lengserkan jokowi klo berhasil kan dia yg naik gantikan jd presiden seperti pak Harto diganti habibie	['main lengser jokowi hasil ganti presiden sepe i o ganti habibie']	negative
USER USER cermati deh.. dari pedea mules ke toilet.. ke toilet ngapain klo ga eek? eek darimna???'	['cermat deh pedean mules toilet toilet tai tai']	positive
USER Apasi anjing lu lebay geblek'	['sih anjing lebay geblek']	negative
ehem USER ... kayaknya sudah saatnya di turunkan pakde USER nih. akal sehatnya ga jalan	['hem kayak turun pakde nih akal sehat jalan']	negative
#Kertayu; #Muba; #Sedekah_Bumi; #Lempar_Lemang; #Info_Budaya; Warga Desa Kertayu menggelar tradisi sedekah bumi berupa pembuatan dan pembakaran lemang. Tradisi budaya yang rutin dilaksanakan setiap...	['ayu mubah sedekah bumi lempar lemang info budaya warga desa ayu gelar tradisi sedekah bumi buat bakar lemang tradisi budaya rutin laksana']	negative
Ini baru Presiden .; ; Keluhan bupati dn masyarakat pulau samosir masalah kekurangan kapal peri dn pelabuhan langsung di jawab dn di sanggupi .; ; Presiden memerintahkan MENHUB harus menyediakan kapal peri yg bagus thn ini Dn pembangunan pelabuhan nya ..;	['presiden keluh bupati masyarakat pulau samosir kurang kapal peri labuh langsung sanggup presiden perintah menteri hubung sedia kapal peri bagus bangun labuh nya']	neutral
Ekonomi dipegang Gerindra? Bisa hancur negara kita. Masak sarankan cetak uang sebanyak2 utk bayar hutang, jadi gk perlu hutang lg. Malah bs ngutangi negara lain. Bisa2nya bilang biaya produksi cetak uang murah. Ekonomi comberan; ; Para kecoa yg baik, yakin,1,1,0,1,0,0,0,0,1,0,1,0;;;;;;;;;;;;	['ekonomi pegang gerindra hancur negara masak saran cetak uang bayar hutang hutang utang negara bisa bilang biaya produksi cetak uang murah ekonomi comberan kecoa 1 1 0 1 0 0 0 0 1 0 1 0']	negative
USER Dulu 98 dollar 12.000 koar-koar minta rezim lengser. Sekarang sudah mau tembus 15.000 malah makin jadi penjilat penguasa. Kasihan rakyat selalu jadi korban propaganda politikus busuk.'	['98 dolar 12 000 koar koar rezim lengser tembus 15 000 jilat kuasa kasihan rakyat korban propaganda politikus busuk']	negative
USER masi pagu ngajak gelut onta'	['pagu ajak gelut onta']	negative
USER USER Lu aja pling blum pernah ngewe'	['ngewe']	negative
Prof. Jeffrey Winters: Jokowi Presiden Terlemah dalam Sejarah Indonesia ; ; Anisa dan Pembahasan Prof Jeffrey Winters ini bagus, walau ini anlisa 2015 lalu, tapi yg menjadi pembahasannya akrg byk yg terjadi.; #2019GantiPresiden; ;,1,0,1,0,0,0,0,0,1,1,0,0;;;;;;;;;;;;	['prof jeffrey musim dingin jokowi presiden lemah sejarah indonesia anisa bahas prof jeffrey musim dingin bagus analisis 2015 bahas 2019 ganti presiden 1 0 1 0 0 0 0 0 1 1 0 0']	negative
Dia digendong namun tetap tdk sombong. Dipanggul namun tetap tidak merasa unggul. Dan dihormati namun tetap rendah hati. Dialah USER; ; Kalian tahu siapa mereka yg memanggul Presiden kita? Mereka adlh pasukan elit TNI penjaga kedaulatan NKRI, bukan juru,0,0,0,0,0,0,0,0,0,0,0,0;;;;;;;;;;;;	['gendong sombong panggul unggul hormat rendah hati panggul presiden pasu elite tentara nasional indonesia jaga daulat negara satu republik indonesia juru 0 0 0 0 0 0 0 0 0 0 0 0']	negative
USER USER USER USER USER USER USER USER USER USER USER USER USER USER USER USER USER USER USER Ooo PKS dan FPI isl	['ooo partai adil sejahtera front bela islam isl']	neutral
USER USER Ya Allah aku berlindung kepada-Mua dari godaan setan yg terkutuk!'	['ya allah lindung mua goda setan kutuk']	negative
Pecun.kelas teri nih\xf0\x9f\x98\x80 URL	['pecun kelas teri nih xf0 x9f x98 x80 uniform resource locator']	neutral
ahok targetkan audit kisruh bantar gebang selesai bulan ini ahok mengatakan audit ini akan digunakan untuk	['ahok target audit kisruh bantar gebang selesai ahok audit']	negative
jongos cina merasa kemerdekaan indonesia cina yang kasih.	['jongos cina merdeka indonesia cina kasih']	negative
Pendapat Profesor - Pemenang Debat Pilkada Jatim	['dapat profesor menang debat pilih kepala daerah jawa timur']	neutral
kenapaa oh kenapaa diriku brengsek'	['oh diri berengsek']	negative
USER Pak USER menghapus Teroris Islam secara efektif harus dijelaskan Alquran adalah Kitab Teroris	['hapus teroris islam efektif alquran kitab teroris']	negative
USER Yawlah itu yang Daniel kalo dibeliin micin yang bego sekelurahan itu'	['ya allah daniel beli micin bego lurah']	negative
USER Namanya sesuai.\nOrg yahudi sebut Aaron. Arab sebut Harun. Yahudi sebut Yochanan. Arab sebut Yahya.'	['nama sesuai orang yahudi aron arab harun yahudi yochanan arab yahya']	negative
Mari ingatkan sekaligus dukung pemerintah, utk tetap kelola ekonomi &amp; kesejahteraan rakyat, meskipun kita berada di tahun politik *SBY*,0,0,0,0,0,0,0,0,0,0,0,0;;;;;;;;;;;;	['mari ingat dukung perintah kelola ekonomi amp sejahtera rakyat politik susilo bambang yudhoyono 0 0 0 0 0 0 0 0 0 0 0 0']	neutral
RT USER USER USER USER USER Prabowo sangat layak jadi calon presiden tapi sangat tidak layak jadi presiden	['prabowo layak calon presiden layak presiden']	neutral
emang ya anjir kalo ke songgoriti naik motor berdua cewek cowok langsung ditawarin villa.'	['ya anjir songgoriti motor dua cewek cowok langsung tawar vila']	negative
JKW ERA: Percuma pembangunan duit utang semua..	['jokowi era bangun duit utang']	negative
Beriman kepada Allah SWT yang dungu & biadab? Anda mendungukan & membiadabkan bangsa	['iman allah subhanahu wa taala dungu biadab dungu biadab bangsa']	negative
RT USER: USER USER USER Klop prabowo pemberontak sekaligus koruptor.	['klop prabowo berontak koruptor']	positive
USER udik udah mendarah daging di kamu'	['udik darah daging']	negative
Nanti ada baju Muslim bertuliskan:; ; #2019GantiPresiden; #2019PrabowoPresiden	['baju muslim be uliskan 2019 ganti presiden 2019 prabowo presiden']	negative
Kunjungan Presiden Joko Widodo pada #PadaKaryaTunai di Pelabuhan Ratu, Sukabumi. ; ; Desa Citarik telah berhasil merubah desanya dari tempat pembuangan sampah yang bau dan kumuh menjadi tepat wisata resapan air dan menjadikan sampah sebagai produk yang mem,0,0,0,0,0,0,0,0,0,0,0,0;;;;;;;;;;;;	['kunjung presiden joko widodo karya tunai labuh ratu sukabumi desa citarik hasil ubah desa buang sampah bau kumuh wisata resap air jadi sampah produk mem 0 0 0 0 0 0 0 0 0 0 0 0']	negative
Pemkot Cirebon optimis mampu merekam 19.000 calon pemilih pemula yang masih berstatus pelajar SMA	['perintah kota cirebon optimis rekam 19 000 calon pilih mula status ajar']	neutral
USER Knp nun? Ada bom?'	['nun bom']	negative
sinden banci kocak princes aprilia &amp; mimin onggo inggi: URL melalui USER'	['sinden banci kocak princess aprilia amp admin onggo inggi uniform resource locator']	negative
Mobile langend memang babi anjeng xnk kasi naik rank kimakkk team Noob babi bocahh setan'	['mobile legend babi anjing xnk kasih rank kimakkk tim noob babi bocah setan']	negative
Mengenal Walpri Perempuan dalam Pilkada Bondowoso; USER	['kenal awal pribadi perempuan pilih kepala daerah bondowoso']	neutral
Bandel Juga Ini Kakek \xf0\x9f\xa4\xa3\nUSER USER USER USER\n#bokep #bokepindo #ngentot #bokepasian #crot #bokephot #horny #sange #kontol #boobs #blowjob #milf #blondecum #filmmalam #nontonbokep #bokeponline\nURL	['bandel kakek xf0 x9f xa4 xa3 bokep bokep indo ngentot bokep asia crot bokep hot horny sange kontol boobs blowjob milf blonde cum film malam tonton bokep bokep online nurl']	positive
RT USER USER Jadi dukung koruptor! Bubarkan kpk. Pantesan... dari situlah issue issue pki keluar. Dasar koruptor	['dukung koruptor bubar komisi berantas korupsi situ isu isu partai komunis indonesia dasar koruptor']	negative
USER USER TKA Cina memang dimanja....'	['tenaga kerja asing cina manja']	negative
Siapa yg bisa masukin ke google web/blogger/forum/situs dewasa aku kasih bonus\n\n#jablay #abg #lonte #bispak #bugil #naked #toge #puting #jilboob #binal #bisyar #ayamkampus #tantegirang #ngewe #ngentot #porn #naked #bigtits #PascolMania #cocktribute #c	['masuk google web blogger forum situs dewasa kasih bonus jablay abg lonte bispak bugil naked toge puting jilboobs binal bisyar ayam kampus tante girang ngewe ngentot porno naked banget pascol mania cocktribute c']	positive
Nasionalis Agamis = Soedurisme; Ir Soekarno adalah bapak nasionalis yang menyatukan rakyat. ; Gus Dur adalah sosok yang Agamis yang menyatukan umat dari berbagai agama.; ; Pak USER Dan cak USER sosok yang tepat untuk melanjutkan perjuangan Indones	['nasionalis agam soedurisme insinyur soekarno nasionalis satu rakyat gus dur sosok agam satu umat agama cak sosok lanjut juang indonesia']	neutral
USER Uteknya di silit'	['otak silit']	positive
Hanya orang bodoh jika beropini bahwa PKI tdk bangkit.presiden cuma pinter akting & pencitraan.Intelijen TNI yg bicara adanya PKI bangkit.	['orang bodoh opini partai komunis indonesia bangkit presiden pintar akting citra intelijen tentara nasional indonesia bicara partai komunis indonesia bangkit']	negative
RT USER: USER jangan sampai Indonesia diambil alih sama cina... Apa perlu kita semua BoikotProdukChina ???	['indonesia ambil alih cina boikot produk cina']	negative
USER USER USER USER Ga penting ngpain lu komen. Kan tolol \xf0\x9f\x98\x82\xf0\x9f\x98\x82\xf0\x9f\x98\x82'	['ngapain komen tolol xf0 x9f x98 x82 xf0 x9f x98 x82 xf0 x9f x98 x82']	negative
USER Kalo dia mah banyak yang mau bloon'	['']	negative
USER fiks dia sinting'	['fix sinting']	neutral
Mamat tu masuk dalam Van! Celah mana kereta lai rosak tu setan. Dasarrrr'	['mamat masuk van celah kereta lai rusak setan dasarrrr']	negative
"Dagangan Islam Nusantara, lah ngapa baru rame skg?, dulu"" kemana aja?, And, semoga ada juga Kristen Nusantara dll yang berbau Nusantara..',0,0,0,0,0,0,0,0,0,0,0,0;;;;;;;;;;;;"	['dagang islam nusantara ramai mana and moga kristen nusantara bau nusantara 0 0 0 0 0 0 0 0 0 0 0 0']	negative
USER 1. Bangsat\n2. Cebong\n3. Kecoak\n4. Bajingan\n5. Taik ayam\n6. Uanjing\n7. Bodat\n8. Cecurut\n9. Borax\n10. Kucirap'	['1 bangsat n2 cebong n3 kecoak n4 bajing n5 tai ayam n6 anjing n7 monyet n8 cecurut n9 boraks n10 kucirap']	negative
RT USER: USER Manis cuman di awal. Butut Goblog!!!!! #SolerOut #HerjosOut'	['manis butut goblok soler out herjos out']	negative
USER Aku mau ngentot sama kamu'	['ngentot']	negative
USER USER USER Udah menghina tapi ngga malu menggunakan fasilitas yg pemerintah bikin! Bani daster ngga tau malu! Ngga punya harga diri makan gaji Dr negara yg Dia hina! Haram! !!'	['hina malu fasilitas perintah bikin bani daster tau malu harga makan gaji negara hina haram']	negative
Menhub: Presiden Jokowi Berikan Berbagai Ide dan Arahan Penting Dalam Proses Pembangunan Bandara Kertajati	['menteri hubung presiden jokowi ide arah proses bangun bandara ajati']	positive
"dapet kabar kalo di barel ui ada bom. yaAllah kasian bgt ya yg kost deket situ:')"",0,0,0,0,0,0,0,0,0,0,0,0;;;;;;;;;;;;"	['kabar barel oi bom ya allah kasihan banget ya indekos situ 0 0 0 0 0 0 0 0 0 0 0 0']	negative
USER Ga juga. Ga ada orang kaya di sekolah2 negeri ;)\n\nYg beneran beragam kayaknya sekolah2 Kristen yg ga mahal. Kaya, miskin, macam2 etnis',0,0,0,0,0,0,0,0,0,0,0,0;;;;;;;;;;;;	['orang kayak sekolah sekolah negeri benar agam kayak sekolah sekolah kristen mahal kayak miskin etnis 0 0 0 0 0 0 0 0 0 0 0 0']	negative
USER USER USER USER Maksud saya, pendidikan jangan dibatasi. Helen Keller wanita bisu tuli dan buta bisa mendapatkan gelar sarjana &amp; berprestasi. Steven Hawking bisa tetap mengembangkan ilmu didalam kelumpuhannya. Tidak,0,0,0,0,0,0,0,0,0,0,0,0;;;;;;;;;;;;	['maksud didik batas helen keller wanita bisu tuli buta gelar sarjana amp prestasi steven hawking kembang ilmu lumpuh 0 0 0 0 0 0 0 0 0 0 0 0']	neutral
Besok kalau Prabowo nyapres lagi dan teriak-teriak masalah ketimpangan jangan dipercaya. Dia aja ngatain wartawan gaji kecil kok	['besok prabowo calon presiden teriak teriak timpang percaya maki wa awan gaji']	negative
#IndonesiaKuasaiFreeport\nSebagai penghuni freeport ikut bangga si.. yaa semoga tenaga kerja asing ny jg dibatasi lg.. lebih banyak tenaga kerja indonesia yg butuh..'	['indonesiakuasaifreepo huni freepo bangga sih ya moga tenaga kerja asing nya batas tenaga kerja indonesia butuh']	positive
USER USER Sabar saja.. sy fikir ini sebagian dari golongan rakyat indonesia yg bentuk fisiknya manusia tp punya jiwa komunis.. karena golongan komunis itu amat krisis sifat kemanusiaan'	['sabar pikir golong rakyat indonesia bentuk fisik manusia jiwa komunis golong komunis krisis sifat manusia']	negative
USER perek doyan di gagahin :*'	['perek suka gagah']	negative
maksutnya kelas bawah hrs diem gk boleh bicara ya Pak USER itu namanya otoriter	['maksud kelas diam bicara ya nama otoriter']	negative
Emang kalo temennya makan sampah kita jg harus makan sampah gtu? Kan gk sih ya.'	['teman makan sampah makan sampah sih ya']	negative
USER USER USER USER USER USER USER USER USER USER USER USER USER Daripada kau Bodat KOMUNIS TOLOL'	['monyet komunis tolol']	negative
Karena itu Presiden Joko Widodo menginstruksikan Badan Pengawas Keuangan dan	['presiden joko widodo instruksi badan awas uang']	neutral
USER // Kucingnya sipit.'	['kucing sipit']	positive
Ratusan Ulama dan Satri Desak Penganugerahan Gelar Pahlawan Nasional untuk KH Ahmad Sanusi | Pikiran Rakyat	['ratus ulama santri desak anugerah gelar pahlawan nasional kh ahmad sanusi pikir rakyat']	neutral
Soal Munir juga ada kaitannya dengan mengapa Rezim Jokowi sangat anti Islam. Setelah saya twitkan semoga menjadi jelas sejelasnya.	['munir kait rezim jokowi anti islam twitkan moga jelas']	negative
USER USER anaknya pak soemitro begawan ekonomi ...tapi pola pikir admin gerinda ini kayak ngak pernah kuliah...jangan sampai kau fakir ilmu...	['anak soemitro begawan ekonomi pola pikir admin gerinda kayak kuliah fakir ilmu']	negative
Trs temenku liatkan ke aku ss-an story si istri ini tadi. Si istri curhat habis-habisan dan ngatai si suami ini bajingan + nge-mention akun si suami'	['teman lihat screenshoot an cerita sih istri sih istri curhat habis habis katai sih suami bajing nge mention akun sih suami']	negative
Monyet ngebut nabrak anak kecil ! LOL URL	['monyet ngebut tabrak anak wkwk uniform resource locator']	positive
USER haduh tolol yh pendukung rezim ini yah kaya gini....'	['aduh tolol ya dukung rezim ya kayak']	negative
USER USER DIKTATOR JOKOWI jongos organisasi jagal manusia NU lagi ngatur siasat kampanye.	['diktator jokowi jongos organisasi jagal manusia nu atur siasat kampanye']	negative
RT USER Ngawur...sembarang aja Pansus hanya menghambat KPK utk penyelidikan teman2nya yg koruptor bubarkan DPR yg sarang koruptor	['ngawur sembarang panitia khusus hambat komisi berantas korupsi lidi teman teman koruptor bubar dewan wakil rakyat sarang koruptor']	negative
USER Sehat om?????klo ga sehat minum kencing onta dulu'	['sehat om sehat minum kencing onta']	negative
RT USER :kirim bantuan pencitraan	['kirim bantu citra']	neutral
USER EH ANJING G USAH BANYAK BACOD LUH. GUE TANTANG DUEL LUH BANGSAD'	['eh anjing bacot gue tantang duel bangsat']	negative
USER USER Dasar..kunyuk nih nyariduit..modal nipu..bangsat Abu..'	['dasar kunyuk nih cari duit modal tipu bangsat abu']	negative
"USER USER Tak baca brita nya..sy kira ni aki"" mngkin dah punya gangguan jiwa.seandai nya nnti 2019 amin kalah.bisa"" nanti malaikat di bilang kafir dan pro aseng.kasian malaikat,gk ngerti urusan capres tp di bawa"" ma aki"" gila.',1,1,1,0,0,0,1,0,0,1,0,0;;;;;;;;;;;;"	['baca berita nya nih aki ganggu jiwa anda nya 2019 amin kalah malaikat bilang kafir pro asing kasihan malaikat nge i urus calon presiden bawa aki gila 1 1 1 0 0 0 1 0 0 1 0 0']	negative
"USER USER Cari simpati ummat muslim jabar buat pilpres 2019...; Mudah""an ulama &amp; ummat islam jabar tidak terkesima &amp; terpengaruh dg trik dan gaya kemunafikannya si mukidi...,1,0,1,0,0,0,0,0,1,1,0,0;;;;;;;;;;;;"	['cari simpati umat muslim jabar pilih presiden 2019 mudah an ulama amp umat islam jabar kesima amp pengaruh trik gaya munafik sih mukidi 1 0 1 0 0 0 0 0 1 1 0 0']	negative
USER MAMPUS W MAMPUS YUGI MAMPUS LO ONTA ARAB'	['mampus gue mampus yugi mampus onta arab']	negative
USER ; ; -thaqeef; -jdt; -alya; -spek bulat; - tudung ala ala ustazah sekolah agama ð???	['terima kasih johor darul takzim alya spesifikasi bulat tudung ala ala ustazah sekolah agama']	negative
"Jika tidak ada demo berjilid-jilid atas pernyataan USER soal kitab suci adalah fiksi, maka hampir bisa dipastikan tujuan utama gerakan ""Bela Islam"" berjilid-jilid versi 212 dst adalah motif politik untuk menjatuhkan Ahok. Ahok telah menjadi korban.,1,0,0,1,1,0,0,0,0,0,1,0;;;;;;;;;;;;"	['demo jilid jilid nyata kitab suci fiksi tuju utama gera bela islam jilid jilid versi 212 motif politik jatuh ahok ahok korban 1 0 0 1 1 0 0 0 0 0 1 0']	negative
USER USER USER USER Ketahuan kan akhirnya...ngaku sendiri maksa org dipenjara.. Bajingan berkedok agama	['tahu aku paksa orang penjara bajing kedok agama']	negative
tolak berita hoax dan siap mensukseskan pilkada dami di kota kediri:	['tolak berita hoaks sukses pilih kepala daerah dami kota diri']	neutral
USER USER USER USER Yg dongo elu bong.. Yg kampret juga elu kalabong.. Jd ngapain marah2... Dan siapa juga yg nyuruh elu ladenin...elu aja baru netas.. Bong bong'	['dongok bong kampret kalabong marah marah suruh laden tetas bong bong']	negative
Pndukung Prabowo spt ARB, SDA adl org2 bejad tabiatnya kasar termasuk org ini &gt;&gt; USER',1,1,0,1,0,0,0,0,1,0,1,0;;;;;;;;;;;;	['dukung prabowo surat pemberitahuan tahun arb sda orang orang bejat tabiat kasar orang 1 1 0 1 0 0 0 0 1 0 1 0']	negative
"USER ""BACOT LO. ALBUM-ALBUM GUE, BELINYA JUGA PAKE DUIT GUE. GA NGERUGIIN EMAK BAPAK LO INI \xf0\x9f\x98\x91\xf0\x9f\x98\x91\xf0\x9f\x98\x91""\n\xf0\x9f\x94\x9d\xf0\x9f\x94\x9d\xf0\x9f\x94\x9d\nAkibat terlalu sering diceramahin beli album',1,1,1,0,0,0,0,0,1,1,0,0;;;;;;;;;;;;"	['bacot album album gue beli pakai duit gue rugi emak xf0 x9f x98 x91 xf0 x9f x98 x91 xf0 x9f x98 x91 xf0 x9f x94 x9d xf0 x9f x94 x9d xf0 x9f x94 x9d akibat dicerahami beli album 1 1 1 0 0 0 0 0 1 1 0 0']	negative
USER kalo aku: bodo amat-in atau ngelakuin hal2 yg disuka buat nge-distract dari pikiran2 begitu'	['bodoh in suka nge distract pikir pikir']	negative
Nama: Jonru Ginting Status: Terlapor Kasus: Ujaran Kebencian (diduga) Mendukung Anies-Sandi	['nama jonru ginting status lapor ujar benci duga dukung anies sandi']	negative
USER nga usah ngomong luh geblek!!'	['bicara geblek']	neutral
USER mm kalau dipercayain sama org lain sering noob \xf0\x9f\x98\x9f'	['mm percaya orang noob xf0 x9f x98 x9f']	positive
BUBARKAN ILUNI UI	['bubar ikat alumni universitas indonesia oi']	negative
USER USER Kampret yang sebenarnya antek asing.'	['kampret antek asing']	negative
Buku Langka&gt; Tuanku Rao; Teror Agama Islam Mazhab Hambali di Tanah Batak 1816-1833. Tahun 1964. 690 hlm. Hardcover. Minat?	['buku langka tuanku rao teror agama islam mazhab hambali tanah batak 1816 1833 1964 690 halaman hard cover minat']	negative
Calon Presiden Diminta Tes Urine Dia juga minta BNN lakukan tes urine ke semua c #InfoTech #TechDigital	['calon presiden tes urine badan narkotika nasional laku tes urine c informasi teknologi teknologi digital']	neutral
USER gak potonya.. berarti diumpetin.. \n\nberbusa sabun soklin\nmawar cap buaya\nbiasa dikibulin\n wajar ku tak percaya'	['foto bera i sembunyi busa sabun so klin mawar cap buaya kibul wajar ku percaya']	positive
